4 15 50 

0 0 359 308 1096 1097 308 308 1096 1097 308 308 1096 1097 308 308 887 888 308 308 1096 1097 308 308 1096 1097 308 308 1096 1097 308 309 0 0 0 0 0 0 0 0 0 0 0 0 938 889 889 889 889 889 
0 0 0 0 1147 1148 0 0 1147 1148 0 0 1147 1148 0 0 938 939 0 0 1147 1148 0 0 1147 1148 0 0 1147 1148 0 0 0 0 0 0 0 0 0 0 0 0 0 257 257 889 889 889 889 889 
0 0 0 0 1198 1199 0 0 1198 1199 0 0 1198 1199 0 0 989 990 0 0 1198 1199 0 0 1198 1199 0 0 1198 1199 0 0 0 0 0 0 0 0 0 0 0 0 0 0 0 889 889 889 889 889 
0 0 0 0 1249 1250 0 1236 1234 1234 1234 1234 1234 1234 1234 1234 1234 1234 1234 1234 1234 1234 1234 1234 1234 1234 1237 0 1249 1250 0 0 0 0 0 0 0 0 0 0 0 0 0 0 0 889 889 889 889 889 
0 0 0 0 1300 1301 1236 1286 1175 1175 1175 1175 1175 1175 1175 1175 1175 1175 1175 1175 1175 1175 1175 1175 1175 1175 1285 1237 1300 1301 0 0 0 0 0 0 0 0 0 0 0 0 0 0 259 0 0 0 889 889 
0 0 0 0 1351 1236 1286 1287 1351 1352 1405 1406 1351 1352 1405 1406 1142 1143 1405 1406 1351 1352 1405 1406 1351 1352 1233 1285 1237 1352 0 0 0 0 0 0 0 0 0 0 0 0 0 0 259 0 0 0 0 889 
0 0 0 0 1236 1286 1287 0 1402 1403 0 0 1402 1403 0 0 1193 1194 0 0 1402 1403 0 0 1402 1403 0 1233 1285 1237 0 0 0 0 0 0 0 0 0 0 0 0 0 0 259 0 0 0 624 0 
0 0 0 1236 1286 1287 0 0 1606 1607 0 0 1606 1607 0 0 1397 1398 0 0 1606 1607 0 0 1606 1607 0 0 1233 1285 1237 0 0 0 0 0 0 0 0 0 0 0 0 0 259 0 0 0 526 527 
0 0 1236 1286 1287 1658 0 0 1657 1658 0 0 1657 1658 0 0 1448 1449 0 0 1657 1658 0 0 1657 1658 0 0 1657 1233 1285 1237 0 0 0 0 259 0 0 0 0 0 0 0 259 0 0 0 577 578 
0 1236 1286 1287 1657 1658 0 0 1657 1658 0 0 1657 1658 0 0 1448 1449 0 0 1657 1658 0 0 1657 1658 0 0 1657 1658 1233 1285 1237 0 257 0 259 0 257 0 0 0 0 0 259 0 0 0 628 629 
0 0 0 0 0 0 0 0 1657 1658 0 0 1657 1658 0 0 1448 1449 0 0 1657 1658 0 0 1657 1658 0 0 1657 1658 0 1233 1285 1237 260 0 259 0 260 0 0 0 0 0 259 0 0 0 522 523 
0 0 0 0 0 0 0 0 1657 1658 0 0 1657 1658 0 0 1448 1449 0 0 1657 1658 0 0 1657 1658 0 0 1657 1658 0 0 1233 1285 1237 0 259 0 260 0 0 0 0 0 259 636 637 638 639 574 
0 0 0 0 0 0 0 0 0 0 0 0 0 0 0 0 0 0 0 0 0 0 0 0 0 0 0 0 0 0 0 0 0 0 0 0 0 0 0 0 0 0 0 0 0 0 0 0 624 625 
0 0 0 0 0 0 0 0 0 0 0 0 0 0 0 0 0 0 0 0 0 0 0 0 0 0 0 0 0 0 0 0 0 0 0 0 0 0 0 0 0 0 0 0 0 0 0 0 0 0 
0 0 0 0 0 0 0 0 0 0 0 0 0 0 0 0 0 0 0 0 0 0 0 0 0 0 0 0 0 0 0 0 0 0 0 0 0 0 0 0 0 0 0 0 0 0 0 0 0 0

0 0 0 0 0 0 0 0 0 0 0 0 0 0 0 0 0 0 0 0 0 0 0 0 0 0 0 0 0 0 0 0 0 0 0 307 0 307 0 0 0 0 0 0 0 0 0 0 0 0 
0 0 0 256 257 257 258 256 257 257 258 256 257 257 258 256 257 257 258 256 257 257 258 256 257 257 258 256 257 257 258 0 0 0 307 0 155 0 307 0 1818 1819 1820 1821 938 0 0 0 0 0 
0 0 0 0 0 0 0 0 0 0 0 0 0 0 0 0 0 0 0 0 0 0 0 0 0 0 0 0 0 0 0 0 0 0 0 0 313 0 0 0 1869 1870 1871 1872 938 0 0 0 0 0 
0 0 0 0 0 0 0 0 1249 1250 0 0 1249 1250 0 0 1040 1041 0 0 1249 1250 0 0 1249 1250 0 0 0 0 0 0 0 0 0 0 0 0 0 0 1920 1921 1922 1923 938 0 0 0 0 0 
0 0 0 0 0 0 0 0 1300 1301 0 0 1300 1301 0 0 1091 1092 0 0 1300 1301 0 0 1300 1301 0 0 0 0 0 0 0 0 0 0 0 0 0 0 1971 1972 1973 1974 1149 1150 1150 1253 0 0 
0 0 0 0 0 1352 0 0 0 0 1251 1252 0 0 1251 1252 0 0 1251 1252 0 0 1251 1252 0 0 0 0 1351 0 0 0 0 0 0 0 0 0 0 0 2022 2023 2024 2025 0 0 0 1304 1253 0 
0 0 0 0 1402 1403 0 0 0 0 1302 1303 0 0 1302 1303 0 0 1302 1303 0 0 1302 1303 0 0 0 0 1402 1403 0 0 0 0 0 257 257 257 0 0 2073 2074 2075 2076 0 0 0 0 1304 1253 
0 0 0 0 1657 1658 0 0 0 0 0 0 0 0 0 0 0 0 0 0 0 0 0 0 0 0 0 0 1657 1658 0 0 0 313 0 0 307 0 0 313 2124 2125 2126 2127 0 0 0 0 0 1304 
0 0 0 0 1657 1658 0 0 0 0 0 0 0 0 0 0 0 0 0 0 0 0 0 0 0 0 0 0 1657 1658 0 0 0 307 0 0 0 0 0 307 2175 2176 2177 2178 0 0 0 0 0 0 
0 0 0 0 0 0 0 0 0 0 0 0 0 0 0 0 0 0 0 0 0 0 0 0 0 0 0 0 0 0 0 0 0 359 360 0 0 0 360 309 0 0 0 0 0 0 0 0 0 0 
590 590 590 590 590 590 540 0 0 0 0 0 0 0 0 0 0 0 0 0 0 0 0 0 0 0 0 0 0 0 0 0 0 0 0 0 0 0 0 0 0 0 0 0 0 0 0 0 0 0 
641 641 641 534 535 494 591 0 0 0 0 0 0 0 0 0 0 0 0 0 0 0 0 0 0 0 0 0 0 0 0 0 0 0 260 0 0 0 0 0 0 0 0 409 410 411 409 410 411 412 
641 641 641 641 532 533 591 641 641 641 641 494 534 535 535 532 533 494 532 533 641 641 641 641 641 641 641 494 532 533 494 539 539 539 539 539 539 539 536 537 589 590 591 536 537 692 692 692 692 692 
641 641 641 641 641 494 591 641 641 641 641 641 585 586 586 641 641 641 641 641 641 641 641 641 641 641 641 641 641 641 494 494 494 494 494 539 539 539 539 539 494 692 692 692 692 692 692 692 692 692 
641 641 641 641 641 494 534 535 641 641 641 641 641 641 641 641 641 641 641 641 641 641 641 641 641 590 590 590 641 641 641 641 641 641 641 641 641 641 641 539 539 539 539 539 539 539 692 692 692 692

0 0 0 0 0 0 0 0 0 0 0 0 0 0 0 0 0 0 0 0 0 0 0 0 0 0 0 0 0 0 0 0 0 0 0 0 0 0 0 0 0 0 0 0 0 0 0 0 0 0 
0 0 0 0 2026 2027 0 0 2230 2231 0 0 2236 2237 0 0 2232 2233 0 0 2032 2033 0 0 2234 2235 0 0 2028 2029 0 0 0 0 0 359 360 309 0 0 0 0 0 0 0 0 0 0 0 0 
0 0 0 0 2077 2078 0 1393 2281 2282 1394 0 2287 2288 0 1394 2283 2284 1394 0 2083 2084 1394 0 2285 2286 1396 0 2079 2080 0 0 0 0 359 308 308 308 309 0 0 0 0 0 0 0 0 0 0 0 
0 0 0 0 2128 2129 0 1444 2332 2333 1445 1446 2338 2339 1445 1446 2334 2335 1445 1446 2134 2135 1445 1446 2336 2337 1447 0 2130 2131 0 0 0 0 0 13 307 13 0 0 0 0 0 0 0 0 0 0 0 0 
0 0 0 0 2179 2180 0 0 2383 2384 0 0 2389 2390 0 0 2385 2386 0 0 2185 2186 0 0 2387 2388 0 0 2181 2182 0 0 0 0 0 307 7 307 0 0 0 0 0 0 0 531 0 0 0 0 
0 0 0 0 0 0 0 0 0 0 0 0 0 0 0 0 0 0 0 0 0 0 0 0 0 0 0 0 0 0 0 0 0 157 361 13 307 13 361 158 0 0 0 0 0 582 0 0 0 0 
0 0 0 0 0 0 0 0 0 0 0 0 0 0 0 0 0 0 0 0 0 0 0 0 0 0 0 0 0 0 0 0 0 307 0 0 0 0 0 307 0 0 0 0 0 633 0 0 0 0 
0 0 0 0 0 0 0 0 0 0 0 0 0 0 0 0 0 0 0 0 0 0 0 0 0 0 0 0 0 0 0 0 0 0 0 0 0 0 0 0 0 0 0 0 0 684 0 0 0 0 
0 0 0 0 0 0 0 0 0 0 0 0 0 0 0 0 0 0 0 0 0 0 0 0 0 0 0 0 0 0 0 0 0 0 0 0 0 0 0 0 0 0 0 0 0 735 0 0 0 0 
0 0 0 0 0 0 0 0 0 0 0 0 0 0 0 0 0 0 0 0 0 0 0 0 0 0 0 0 0 0 0 0 0 0 0 0 0 0 0 0 0 0 0 0 0 0 0 0 0 0 
0 0 0 0 0 0 0 0 0 0 0 0 0 0 0 0 0 0 0 0 0 0 0 0 0 0 0 0 0 0 0 0 0 0 0 0 0 0 0 0 0 0 0 0 0 0 0 0 0 0 
0 0 0 0 0 0 0 0 0 0 0 0 0 0 0 0 0 0 0 0 0 0 0 0 0 0 0 0 0 0 0 0 0 0 0 0 0 0 0 0 0 0 0 0 0 0 0 0 0 0 
0 0 0 0 0 0 0 0 0 0 0 0 0 0 0 0 0 0 0 0 0 0 0 0 0 0 0 0 0 0 0 0 0 0 0 0 0 0 0 0 0 0 0 0 0 0 0 0 0 0 
0 0 0 0 0 0 0 0 0 0 0 0 0 0 0 0 0 0 0 0 0 0 0 0 0 0 0 0 0 0 0 0 0 0 0 0 0 0 0 0 0 0 0 0 0 0 0 0 0 0 
0 0 0 0 0 0 0 0 0 0 0 0 0 0 0 0 0 0 0 0 0 0 0 0 0 0 0 0 0 0 0 0 0 0 0 0 0 0 0 0 0 0 0 0 0 0 0 0 0 0

0 0 0 0 0 0 0 0 0 0 0 0 0 0 0 0 0 0 0 0 0 0 0 0 0 0 0 0 0 0 0 0 0 0 0 0 0 0 0 0 0 0 0 0 0 0 0 0 0 0 
0 0 0 0 0 0 0 0 0 0 0 0 0 0 0 0 0 0 0 0 0 0 0 0 0 0 0 0 0 0 0 0 0 0 0 0 0 0 0 0 0 0 0 0 0 0 0 0 0 0 
0 0 0 0 0 0 0 0 0 0 0 0 0 0 0 0 0 0 0 0 0 0 0 0 0 0 0 0 0 0 0 0 0 0 0 0 0 0 0 0 0 0 0 0 0 0 0 0 0 0 
0 0 0 0 0 0 0 0 0 0 0 0 0 0 0 0 0 0 0 0 0 0 0 0 0 0 0 0 0 0 0 0 0 0 0 0 0 0 0 0 0 0 0 0 0 0 0 0 0 0 
0 0 0 0 0 0 0 0 0 0 0 0 0 0 0 0 0 0 0 0 0 0 0 0 0 0 0 0 0 0 0 0 0 0 0 0 0 0 0 0 0 0 0 0 0 0 0 0 0 0 
0 0 0 0 0 0 0 0 0 0 0 0 0 0 0 0 0 0 0 0 0 0 0 0 0 0 0 0 0 0 0 0 0 0 0 0 0 0 0 0 0 0 0 0 0 0 0 0 0 0 
0 0 0 0 0 0 0 0 0 0 0 0 0 0 0 0 0 0 0 0 0 0 0 0 0 0 0 0 0 0 0 0 0 0 0 0 0 0 0 0 0 0 0 0 0 0 0 0 0 0 
0 0 0 0 0 0 0 0 0 0 0 0 0 0 0 0 0 0 0 0 0 0 0 0 0 0 0 0 0 0 0 0 0 0 0 0 3 0 0 0 0 0 0 0 0 0 0 0 0 1 
0 0 0 0 0 0 0 0 0 0 0 0 0 0 0 0 0 0 0 0 0 0 0 0 0 0 0 0 0 0 0 0 0 0 0 0 0 0 0 0 0 0 0 0 0 0 0 0 0 1 
0 0 0 0 0 0 0 0 0 0 0 0 0 0 0 0 0 0 0 0 0 0 0 0 0 0 0 0 0 0 0 0 0 0 0 0 0 0 0 0 0 0 0 0 0 0 0 0 0 1 
1 1 1 1 1 1 1 0 0 0 0 0 0 0 0 0 0 0 0 0 0 0 0 0 0 0 0 0 0 0 0 0 0 0 0 0 0 0 0 0 0 0 0 0 0 0 0 0 0 1 
0 0 0 0 0 0 1 0 0 0 0 0 0 0 0 0 0 0 0 0 0 0 0 0 0 0 0 0 0 0 0 0 0 0 0 0 0 0 0 0 0 0 0 0 0 0 0 0 0 1 
0 0 0 0 0 0 1 1 1 1 1 1 1 1 1 1 1 1 1 1 1 1 1 1 1 1 1 1 1 1 1 1 1 1 1 1 1 1 1 1 1 1 1 1 1 1 1 1 1 1 
0 0 0 0 0 0 0 0 0 0 0 0 0 0 0 0 0 0 0 0 0 0 0 0 0 0 0 0 0 0 0 0 0 0 0 0 0 0 0 0 0 0 0 0 0 0 0 0 0 0 
0 0 0 0 0 0 0 0 0 0 0 0 0 0 0 0 0 0 0 0 0 0 0 0 0 0 0 0 0 0 0 0 0 0 0 0 0 0 0 0 0 0 0 0 0 0 0 0 0 0