4 15 60

0 0 0 0 0 0 0 0 0 0 0 0 0 0 0 0 0 0 0 0 0 0 0 0 0 0 0 0 0 0 0 0 0 0 0 0 0 0 0 0 0 0 0 0 0 884 1124 1124 1124 1124 1127 1128 1124 1124 1076 1077 1124 1124 1280 1281 
0 0 0 0 0 0 0 0 0 0 0 0 0 0 0 0 0 0 0 0 0 0 0 0 0 0 0 0 0 0 0 0 0 0 0 0 0 0 0 0 0 0 0 0 0 880 1124 1124 1280 1281 1124 1124 1124 1124 1127 1128 1124 1124 1331 1332 
0 0 0 0 0 0 0 0 159 0 0 0 0 0 0 0 0 0 0 0 0 0 0 0 0 0 0 0 0 0 0 0 0 0 0 0 0 0 0 0 0 0 0 0 0 884 1124 1124 1331 1332 1076 1077 830 831 828 829 1124 1280 1281 1124 
0 0 0 0 0 0 0 0 210 0 0 0 0 0 0 0 0 0 0 0 0 0 0 0 0 0 0 0 0 0 0 0 0 0 0 0 0 0 0 0 0 0 0 0 0 828 829 1124 1124 1124 1127 1128 881 882 879 880 1124 1331 1332 1124 
0 892 893 894 895 896 897 0 261 0 0 0 0 0 0 0 0 0 0 0 0 0 0 0 0 0 0 0 0 0 0 0 0 0 0 0 0 0 0 0 0 0 0 0 0 0 828 1124 1124 1124 1124 1124 932 933 930 931 1124 1124 1124 1124 
0 943 944 945 946 947 948 0 312 0 0 0 0 0 0 0 0 0 0 0 0 0 0 0 0 0 0 0 0 0 0 0 0 0 0 0 0 0 0 0 0 0 0 0 0 0 0 1233 1175 1129 1175 1175 1124 1124 1127 1128 1124 830 831 833 
0 994 995 996 997 998 999 0 210 0 0 0 0 0 0 0 0 0 0 0 0 1548 0 0 0 0 0 0 0 0 0 0 0 0 0 0 0 0 0 0 0 0 0 0 0 0 0 0 0 0 0 259 1129 1076 1077 1124 1124 881 883 884 
2405 2406 1046 1047 1048 1049 1050 0 261 0 0 0 0 0 0 0 0 0 0 0 0 0 0 0 0 0 0 0 0 0 0 0 0 0 0 0 0 0 0 0 0 0 0 0 0 0 0 0 0 0 0 0 1182 1127 1128 1076 1077 932 934 935 
2456 2457 2458 1098 1099 1100 0 0 312 0 0 0 0 0 0 1546 0 0 0 0 0 0 0 0 0 0 0 0 0 0 0 0 0 0 0 161 1913 1914 1915 1916 1917 0 0 0 0 0 0 0 0 0 0 0 1233 1130 1124 1127 1128 1124 1124 1076 
1073 1073 1073 1073 1073 1073 1073 1073 1073 1078 0 0 0 0 0 0 0 0 0 0 0 0 0 0 0 0 0 0 0 0 0 0 0 1029 0 212 1964 1965 1966 1967 1968 0 0 0 0 0 0 0 0 0 0 0 0 1123 1124 1124 1124 1124 1124 1127 
1124 1124 1124 1124 1124 1124 1124 1124 1124 1129 1277 1073 1073 1078 0 0 741 0 0 0 0 0 0 0 0 0 0 0 0 0 1079 1073 1073 1277 1073 1073 1074 2010 2011 2012 1072 1073 1073 1277 1073 1277 1277 1282 0 0 0 0 0 259 1175 1175 1175 1175 1175 1175 
1124 1124 1124 1124 1124 1124 1124 1124 1124 1124 1124 1124 1124 1129 1073 1073 792 0 0 0 0 53 54 55 56 0 0 1283 1073 1073 1130 1124 1124 1124 1124 1124 1125 0 0 0 1123 1124 1124 1124 1124 1124 1124 1333 1277 1277 1282 0 0 0 0 0 0 0 0 0 
1124 1124 1124 1124 1124 1124 1124 1124 1124 1124 1124 1124 1124 1124 1124 1124 1129 1277 1277 1277 1277 104 105 106 107 1073 1073 1130 1124 1124 1124 1124 1124 1124 1124 1124 1125 0 0 0 1123 1124 1124 1124 1124 1124 1124 1124 1124 1124 1333 1277 1282 0 0 0 0 0 0 0 
1124 1124 1124 1124 1124 1124 1124 1124 1124 1124 1124 1124 1124 1124 1124 1124 1124 1124 1124 1124 1124 1129 1073 1073 1130 1124 1124 1124 1124 1124 1124 1124 1124 1124 1124 1124 1125 0 0 0 1123 1124 1124 1124 1124 1124 1124 1124 1124 1124 1124 1124 1129 1277 1078 0 0 0 0 0 
1124 1124 1124 1124 1124 1124 1124 1124 1124 1124 1124 1124 1124 1124 1124 1124 1124 1124 1124 1124 1124 1124 1328 1328 1328 1124 1124 1124 1124 1124 1124 1124 1124 1124 1124 1124 1125 0 0 0 1123 1124 1124 1124 1124 1124 1124 1124 1124 1124 1124 1124 1124 1124 1129 1073 1073 1277 1073 1073

0 0 0 0 0 0 0 0 0 0 0 0 0 0 0 0 0 0 0 0 0 0 0 0 0 0 0 0 0 0 0 0 0 0 0 0 0 0 0 0 0 0 0 0 0 0 0 0 0 0 0 0 0 0 0 0 0 0 2096 2097 
0 0 0 0 0 0 0 0 0 0 0 0 0 0 0 0 0 0 0 0 0 0 0 0 0 0 0 0 0 0 0 0 0 0 0 0 0 0 0 0 0 0 0 0 0 0 0 0 0 0 0 0 0 0 0 0 0 0 2147 2148 
0 0 0 0 0 0 0 0 0 0 0 0 0 0 0 0 0 0 0 0 0 0 0 0 0 0 0 0 0 0 0 0 0 0 0 0 0 0 0 0 0 0 0 0 0 0 0 0 0 0 0 0 0 0 0 0 0 1892 1893 0 
0 0 0 0 0 0 0 0 0 0 0 0 0 0 0 0 0 0 0 0 0 0 0 0 0 0 0 0 0 0 0 0 0 0 0 0 0 0 0 0 0 0 0 0 0 0 0 0 0 0 0 0 0 2408 0 0 0 1943 1944 0 
0 0 0 0 0 0 0 0 257 0 0 0 0 0 0 0 0 0 0 0 0 0 0 0 0 0 0 0 0 0 0 0 0 0 0 0 0 0 0 0 0 0 0 0 0 0 0 0 0 0 0 0 0 2459 0 0 0 0 0 0 
0 0 0 0 0 0 0 0 0 0 0 0 0 0 0 0 0 0 0 0 0 0 0 0 0 0 0 0 0 0 0 0 0 0 0 0 0 0 0 0 0 0 0 0 0 0 0 0 0 0 0 0 0 0 0 0 0 524 525 527 
0 0 0 0 0 0 0 0 0 0 0 0 0 0 0 0 0 0 0 0 155 155 0 0 0 0 0 0 0 0 0 0 0 876 877 878 0 0 0 0 0 0 0 0 870 871 872 0 0 0 0 1233 0 0 0 0 0 575 577 578 
0 0 0 0 0 0 0 0 0 0 0 0 0 0 0 0 0 4 4 4 307 307 0 0 0 0 0 0 0 0 0 0 0 927 928 929 0 0 0 0 0 0 0 0 921 922 923 0 0 0 0 0 0 0 0 2096 2097 626 628 629 
1394 1394 1394 1395 1393 1393 1394 1395 1396 0 0 0 0 0 0 0 0 358 307 307 0 307 0 0 0 868 869 0 0 0 0 0 0 978 979 980 1913 1914 1915 1916 1917 0 0 0 972 973 974 0 0 0 0 0 0 0 0 2147 2148 0 0 1892 
1446 1446 1445 1446 1445 1445 1446 1445 1446 1447 0 2507 2508 0 0 307 307 307 307 307 308 309 0 0 0 919 920 0 0 0 0 1599 1600 1601 1030 0 1964 1965 1966 1967 1968 0 0 0 1023 1024 1025 0 0 0 0 0 0 0 0 0 0 0 0 1943 
0 0 0 0 0 0 0 0 0 0 0 2558 2559 0 0 358 0 0 5 358 0 0 0 0 0 970 971 0 0 0 0 0 0 0 0 0 0 2010 2011 2012 0 0 0 0 0 0 0 0 0 0 0 0 0 1233 0 0 0 0 0 0 
0 0 0 0 0 0 0 0 0 0 0 0 0 0 0 0 1078 5 5 358 0 0 0 0 0 1021 1022 0 0 0 0 0 0 0 0 0 0 0 0 0 0 0 0 0 0 0 0 0 0 0 0 0 0 0 0 310 0 0 0 0 
0 0 0 0 0 0 0 0 0 0 0 0 0 0 0 0 0 0 0 0 0 1078 0 0 1079 0 0 0 0 0 0 0 0 0 0 0 0 0 0 0 0 0 0 0 0 0 0 0 0 0 0 0 0 0 0 0 0 0 0 0 
0 0 0 0 0 0 0 0 0 0 0 0 0 0 0 0 0 0 0 0 0 0 0 0 0 0 0 0 0 0 0 0 0 0 0 0 0 0 0 0 0 0 0 0 0 0 0 0 0 0 0 0 0 1889 1894 0 0 0 0 0 
0 0 0 0 0 0 0 0 0 0 0 0 0 0 0 0 0 0 0 0 0 0 0 0 0 0 0 0 0 0 0 0 0 0 0 0 0 54 55 56 0 0 0 0 0 0 0 0 0 0 0 0 0 0 0 1889 1889 2093 2093 2093

0 0 0 0 0 0 0 0 0 0 0 0 0 0 0 0 0 0 0 0 0 0 0 0 0 0 0 0 0 0 0 0 0 0 0 0 0 0 0 0 0 0 0 0 0 0 0 0 0 0 0 0 0 0 0 0 0 0 0 0 
0 0 0 0 0 0 0 0 0 0 0 0 0 0 0 0 0 0 0 0 0 0 0 0 0 0 0 0 0 0 0 0 0 0 0 0 0 0 0 0 0 0 0 0 0 0 0 0 0 0 0 0 0 0 0 0 0 0 0 0 
0 0 0 0 0 0 0 0 0 0 0 0 0 0 0 0 0 0 0 0 0 0 0 0 0 0 0 0 0 0 0 0 0 0 0 0 0 0 0 0 0 0 0 0 0 0 0 0 0 0 0 0 0 0 0 0 0 0 0 0 
0 0 0 0 0 0 0 0 159 0 0 0 0 0 0 0 0 0 0 0 0 0 0 0 0 0 0 0 0 0 0 0 0 0 0 0 0 0 0 0 0 0 0 0 0 0 0 0 0 0 0 0 0 0 0 0 0 0 0 0 
0 0 0 0 0 0 0 0 1729 0 0 0 0 0 0 0 0 0 0 0 0 0 0 0 0 0 0 0 0 0 0 0 0 0 0 0 0 0 0 0 0 0 0 0 0 0 0 0 0 0 0 0 0 0 0 0 0 0 0 0 
0 0 0 0 0 0 0 0 1780 0 0 0 0 0 0 0 0 0 0 0 0 0 0 0 0 0 0 0 0 0 0 0 0 0 0 0 0 0 0 0 0 0 0 0 0 0 0 0 0 0 0 0 0 0 0 0 0 0 0 0 
0 0 0 0 0 0 0 0 0 0 0 0 0 0 0 0 0 0 0 0 0 0 0 0 0 0 0 0 0 0 0 870 871 872 0 0 0 0 0 0 0 0 0 868 869 0 0 0 0 0 0 0 0 0 0 0 0 0 0 0 
0 0 2409 0 0 0 0 0 0 0 0 0 0 0 0 0 0 0 0 0 1824 1825 0 0 0 0 0 0 0 0 0 921 922 923 0 0 0 0 0 0 0 0 0 919 920 0 0 0 0 0 0 259 0 0 0 0 0 0 0 0 
0 0 2460 1596 1598 1495 1496 1497 1498 0 2408 0 0 0 0 0 0 0 0 0 1875 1876 0 0 0 0 0 0 0 0 0 972 973 974 0 0 0 0 0 0 0 2408 0 970 971 0 0 0 0 0 0 259 0 0 0 0 0 0 0 0 
0 0 0 0 0 0 0 0 0 0 2459 0 0 0 0 0 0 0 0 0 1926 1927 0 0 0 0 0 0 0 0 0 1023 1024 1025 636 639 0 0 0 0 0 2459 0 1021 1022 0 0 0 0 0 0 259 0 0 0 0 0 0 0 0 
0 0 0 0 0 0 0 0 0 0 0 0 0 0 636 639 0 0 0 0 1977 1978 0 0 0 0 0 0 636 637 0 0 0 0 0 0 0 0 0 0 0 0 0 0 0 0 0 0 639 639 0 259 0 0 0 0 0 0 468 469 
0 0 0 0 0 0 0 0 0 0 0 0 0 0 0 0 0 409 410 411 412 0 0 0 0 636 638 0 0 0 0 0 0 0 0 0 0 0 0 0 0 0 0 0 0 0 0 0 0 0 0 259 0 259 0 0 260 0 519 520 
0 0 0 0 0 0 0 0 0 0 0 0 0 0 0 0 0 0 0 0 0 0 637 638 0 0 0 0 0 0 0 0 0 0 0 0 0 0 0 0 0 0 0 0 0 0 0 0 0 0 0 0 0 259 0 0 260 0 570 571 
0 0 0 0 0 0 0 0 0 0 0 0 0 0 0 0 0 0 0 0 0 0 0 0 0 0 0 0 0 0 0 0 0 0 0 0 0 0 0 0 0 0 0 0 0 0 0 0 0 0 0 0 0 0 0 0 260 0 621 622 
0 0 0 0 0 0 0 0 0 0 0 0 0 0 0 0 0 0 0 0 0 0 0 0 0 0 0 0 0 0 0 0 0 0 0 0 0 0 0 0 0 0 0 0 0 0 0 0 0 0 0 0 0 0 0 0 0 0 0 0

1 1 1 1 1 1 1 1 1 1 1 1 1 1 1 1 1 1 1 1 1 1 1 1 1 1 1 1 1 1 1 1 1 1 1 1 1 1 1 1 1 1 1 1 1 1 0 0 0 0 0 0 0 0 0 0 0 0 0 0 
1 0 0 0 0 0 0 0 0 0 0 0 0 0 0 0 0 0 0 0 0 0 0 0 0 0 0 0 0 0 0 0 0 0 0 0 0 0 0 0 0 0 0 0 0 1 0 0 0 0 0 0 0 0 0 0 0 0 0 0 
1 0 0 0 0 0 0 0 0 0 0 0 0 0 0 0 0 0 0 0 0 0 0 0 0 0 0 0 0 0 0 0 0 0 0 0 0 0 0 0 0 0 0 0 0 1 0 0 0 0 0 0 0 0 0 0 0 0 0 0 
1 0 0 0 0 0 0 0 0 0 0 0 0 0 0 0 0 0 0 0 0 0 0 0 0 0 0 0 0 0 0 0 0 0 0 0 0 0 0 0 0 0 0 0 0 1 1 0 0 0 0 0 0 0 0 0 0 0 0 0 
1 0 0 0 0 0 0 0 0 0 0 0 0 0 0 0 0 0 0 0 0 0 0 0 0 0 0 0 0 0 0 0 0 0 0 0 0 0 0 0 0 0 0 0 0 0 1 1 0 0 0 0 0 0 0 0 0 0 0 0 
1 0 0 0 0 0 0 0 0 0 0 0 0 0 0 0 0 0 0 0 0 0 0 0 0 0 0 0 0 0 0 0 0 0 0 0 0 0 0 0 0 0 0 0 0 0 0 1 1 1 1 1 0 0 0 0 0 0 0 0 
1 0 0 0 0 0 0 0 0 0 0 0 0 0 0 0 0 0 0 0 0 0 0 0 0 0 0 0 0 0 0 0 0 0 0 0 0 0 0 0 0 0 0 0 0 0 0 0 0 0 0 0 1 1 0 0 0 0 0 0 
1 0 0 0 0 0 0 0 0 0 0 0 0 0 0 0 0 0 0 0 0 0 0 0 0 0 0 0 0 0 0 2 0 0 0 0 0 0 0 0 0 0 0 0 2 0 0 0 0 0 0 0 0 1 1 1 0 0 0 0 
1 0 0 0 0 0 0 0 0 0 0 0 0 0 0 0 0 0 0 0 0 0 0 0 0 0 0 0 0 0 0 0 0 0 0 0 0 0 0 0 0 0 0 0 0 0 0 0 0 0 0 0 0 0 0 1 1 1 1 1 
1 1 1 1 1 1 1 1 1 0 0 0 0 0 0 0 0 0 0 2 0 0 0 0 0 0 0 0 0 0 0 0 0 0 0 0 0 0 0 0 0 0 0 0 0 0 0 0 0 0 0 0 0 0 0 0 0 0 0 0 
0 0 0 0 0 0 0 0 1 1 1 1 1 0 0 0 0 0 0 0 0 0 0 0 0 0 0 0 0 0 0 1 1 1 1 1 1 1 1 1 1 1 1 1 1 1 1 0 0 0 0 0 0 0 0 0 0 0 0 0 
0 0 0 0 0 0 0 0 0 0 0 0 1 1 1 1 0 0 0 0 0 0 0 0 0 0 0 0 1 1 1 1 0 0 0 0 0 0 0 0 0 0 0 0 0 0 1 1 1 1 0 0 0 0 0 0 0 0 0 0 
0 0 0 0 0 0 0 0 0 0 0 0 0 0 0 1 1 1 1 1 1 0 0 0 0 1 1 1 1 0 0 0 0 0 0 0 0 0 0 0 0 0 0 0 0 0 0 0 0 1 1 1 0 0 0 0 0 0 0 0 
0 0 0 0 0 0 0 0 0 0 0 0 0 0 0 0 0 0 0 0 1 1 1 1 1 1 0 0 0 0 0 0 0 0 0 0 0 0 0 0 0 0 0 0 0 0 0 0 0 0 0 1 1 1 0 0 0 0 0 0 
0 0 0 0 0 0 0 0 0 0 0 0 0 0 0 0 0 0 0 0 0 0 0 0 0 0 0 0 0 0 0 0 0 0 0 0 0 0 0 0 0 0 0 0 0 0 0 0 0 0 0 0 0 1 1 1 1 1 1 1
