4 15 100

0 0 0 0 0 0 0 0 0 0 0 0 0 0 2524 2475 2423 2423 2374 0 0 0 0 0 0 0 0 0 0 0 0 0 0 0 0 0 0 0 0 0 0 0 0 0 0 0 0 0 0 0 0 0 0 0 0 0 0 0 0 0 0 0 0 0 0 0 0 0 0 0 0 0 0 0 0 0 0 0 0 0 0 0 0 0 0 0 0 0 0 0 0 0 0 0 0 0 0 0 0 0 
0 0 0 0 0 0 0 0 0 0 0 0 0 0 0 2524 2475 2424 2425 2426 0 0 0 0 0 0 0 0 0 0 0 0 0 0 0 206 206 0 0 0 0 0 0 0 0 0 0 0 0 0 0 0 0 0 0 0 0 0 0 0 0 0 0 0 0 0 0 0 0 0 0 0 0 0 0 0 0 0 0 0 0 0 0 0 0 0 0 0 0 0 0 0 0 0 0 0 0 0 0 0 
0 0 0 0 0 0 0 0 0 0 0 0 0 0 0 0 2524 2525 2424 2425 2374 0 0 0 0 0 0 0 0 35 36 37 38 0 0 260 0 0 0 0 0 0 0 0 0 2372 2374 0 0 0 0 0 0 0 0 0 0 0 0 0 0 1065 1066 1067 0 0 0 0 0 0 0 0 0 0 0 0 206 206 313 0 0 0 0 0 0 0 0 0 0 0 0 0 0 0 0 0 0 0 0 0 
0 0 0 0 0 0 0 0 0 0 0 0 0 0 0 0 0 2576 2525 2475 2425 2426 0 0 0 0 0 0 85 86 87 88 89 0 0 260 0 0 0 0 0 2372 2373 2374 2372 2424 2425 2426 0 0 0 0 0 0 0 0 0 0 1113 1114 1115 1116 1117 1118 1119 0 0 0 0 0 0 0 0 0 0 0 0 0 360 0 0 0 0 0 0 0 0 0 0 0 0 0 0 0 0 0 0 0 0 0 
0 0 0 0 0 0 0 0 0 0 0 0 0 0 0 0 0 0 2524 2525 2475 2475 2374 0 0 0 0 0 136 137 138 139 140 0 0 260 0 0 0 0 2372 2527 2577 2525 2526 2475 2475 2425 2374 0 0 0 0 0 0 0 0 1163 1164 1165 1166 1167 1168 1169 1170 0 0 0 0 0 0 0 0 0 0 0 0 0 313 0 0 0 0 0 0 0 0 0 0 0 0 0 0 0 0 0 0 0 0 0 
0 0 0 0 0 0 0 0 0 0 0 0 0 0 0 0 0 0 0 2576 2525 2475 2425 2426 0 0 0 0 187 188 189 190 191 0 0 260 0 0 0 2372 2423 2528 0 2576 2577 2577 2577 2525 2425 2426 0 0 0 0 0 0 0 1214 1215 1216 1217 1218 1219 1220 1221 0 0 0 0 0 0 0 0 0 0 0 0 0 313 22 23 24 25 26 0 0 0 0 0 0 0 209 0 0 0 0 0 382 383 384 
0 531 0 0 0 0 0 0 0 0 0 0 0 0 0 0 0 0 0 0 2524 2525 2475 2425 2374 0 0 0 0 0 240 241 242 2303 0 260 0 0 2372 2423 2528 0 0 0 0 0 0 2524 2525 2425 2426 0 0 0 0 0 0 1265 1266 1267 1268 1269 1270 1271 1272 0 0 0 0 0 0 0 0 0 0 0 0 0 313 73 74 75 76 77 120 121 122 123 0 0 0 260 0 0 0 0 0 433 434 435 
0 582 0 0 0 0 0 0 0 0 0 0 0 0 0 0 0 0 0 0 0 2576 2525 2475 2425 2426 0 0 0 0 291 2304 0 2305 0 2404 2306 2422 2423 2528 0 0 0 0 0 0 0 0 2524 2525 2425 2374 0 0 0 0 0 1316 1317 1318 1319 1320 1321 1322 1323 0 0 0 0 0 0 0 0 0 0 0 0 0 313 167 125 126 127 128 0 0 0 0 0 0 0 0 0 0 0 0 382 484 485 486 
0 633 0 0 0 0 0 0 2160 2161 2268 2269 0 0 0 0 0 0 0 0 0 0 2473 2424 2476 2477 0 0 0 0 0 0 0 0 0 0 2404 2473 2527 2528 2268 2269 2273 2274 0 0 0 0 0 2524 2525 2425 2373 2373 2373 2374 0 1367 1368 1369 1370 1371 1372 1373 1374 0 0 0 0 0 0 0 0 0 0 0 0 0 0 0 0 0 0 0 0 0 0 0 0 0 0 0 0 0 0 0 433 434 435 436 
0 684 0 0 0 0 2164 0 2211 2212 2319 2320 0 2213 2214 0 0 0 0 0 0 0 2473 2475 2527 2528 0 0 0 0 0 0 0 0 0 0 0 0 2578 2579 2319 2320 2324 2325 0 0 2304 2306 0 0 2524 2525 2475 2424 2424 2425 2426 1418 1419 1420 1421 1422 1423 1424 1425 0 0 0 0 0 0 0 0 0 0 0 0 0 0 0 18 0 0 0 0 531 0 0 0 0 0 684 0 0 0 0 484 485 486 280 
0 735 0 0 2273 0 2215 0 2204 0 0 0 0 0 0 0 0 0 0 2213 2214 2372 2423 2475 2578 0 0 0 0 2403 2404 0 0 0 0 0 0 0 0 0 0 0 0 0 0 0 0 0 0 0 0 2576 2525 2475 2475 2476 2477 1469 1470 1471 1472 0 1474 1475 1476 0 0 0 0 0 0 120 121 122 123 122 119 119 120 121 69 0 0 0 0 531 0 0 0 0 0 684 0 18 0 0 0 0 0 0 
0 786 0 0 2324 2325 0 0 0 0 0 0 0 0 0 0 0 0 0 0 0 2525 2527 2528 0 0 0 0 0 0 0 0 0 0 0 0 0 0 0 0 0 0 0 0 0 0 0 0 0 0 2101 2301 2473 2526 2526 2527 2528 0 0 0 1523 0 0 1526 1527 0 0 0 0 0 0 0 0 0 0 0 0 0 0 0 0 0 0 0 0 582 0 0 0 0 0 684 0 69 70 71 72 165 167 165 
0 0 0 0 0 0 0 0 0 0 0 0 0 0 0 0 0 0 0 0 0 2525 2578 0 0 0 0 0 0 0 0 0 0 0 0 0 0 0 0 0 0 0 0 0 0 0 0 0 0 0 0 0 0 0 0 0 0 0 2103 2301 1574 2301 2302 2302 2301 2103 2299 0 0 0 0 0 0 0 0 0 0 0 0 0 0 0 0 0 0 531 0 0 0 0 0 0 0 0 0 0 0 0 0 0 
0 0 0 0 0 0 0 0 0 0 0 0 0 0 0 0 0 0 0 0 0 0 0 0 0 0 0 0 0 0 0 0 0 0 0 0 0 0 0 0 0 0 0 0 0 155 0 0 0 0 0 0 0 0 0 0 0 0 0 0 0 0 0 0 0 0 0 0 0 0 0 0 0 0 0 0 0 0 0 0 0 0 0 0 0 786 0 0 0 0 0 0 0 0 0 0 0 0 0 0 
0 0 0 0 0 0 0 0 0 0 0 0 0 0 0 0 0 0 0 0 0 0 0 0 0 0 0 0 0 0 0 0 0 0 0 0 0 0 0 0 0 0 0 0 359 307 360 360 360 360 360 0 0 0 0 0 0 0 0 0 0 0 0 0 0 0 0 0 0 0 0 0 0 0 0 0 0 0 0 0 0 0 0 0 0 531 0 0 0 0 0 0 0 0 0 0 0 0 0 0

1949 1949 1949 1949 1949 1949 1949 1542 0 0 0 0 0 0 0 0 0 0 0 0 0 0 0 0 0 0 0 0 0 0 0 0 0 359 307 308 308 307 309 0 0 0 0 0 0 0 0 0 0 0 0 0 0 0 0 0 0 0 0 0 0 0 399 400 401 402 0 0 0 0 0 0 0 0 0 0 0 0 0 0 0 0 0 0 0 0 0 0 0 0 0 0 0 0 0 0 0 0 0 0 
1949 1949 1949 1949 1492 1493 2001 2002 0 0 1628 0 0 0 0 0 0 0 0 0 0 0 0 0 0 0 0 0 0 0 0 0 0 0 359 307 308 309 0 0 0 0 0 0 0 0 0 0 0 0 0 0 0 0 0 0 0 0 0 0 0 0 450 451 452 453 454 0 0 0 0 0 0 0 0 0 0 0 0 0 0 0 0 0 0 0 0 0 0 0 0 0 0 0 0 0 0 0 0 0 
1949 1949 1949 1949 1543 1595 2052 2053 0 0 1679 0 0 0 0 0 0 0 0 0 0 0 0 0 0 0 0 0 0 0 0 0 0 0 0 0 0 0 0 0 0 0 0 0 0 0 0 0 0 0 0 0 0 0 0 0 0 0 0 0 0 0 501 502 503 504 505 0 0 0 0 0 0 0 0 0 0 0 0 0 0 0 0 0 0 0 0 0 0 0 0 0 0 0 0 0 0 0 0 0 
1949 1949 1949 1949 2001 2002 0 0 0 0 0 0 0 0 0 0 0 0 0 0 0 0 0 0 0 0 0 0 0 0 0 0 0 0 0 0 0 0 0 0 0 0 0 0 0 0 0 0 0 0 0 0 0 0 0 0 0 0 0 0 0 551 552 553 554 555 556 557 0 0 0 0 0 0 0 0 0 0 313 0 0 0 0 0 0 0 0 0 0 329 0 0 0 0 0 0 0 0 0 0 
2051 2052 2051 2052 2052 2053 0 0 0 0 0 0 0 0 0 0 0 0 0 0 0 0 0 0 0 0 0 0 0 0 0 0 0 0 0 0 0 0 0 0 0 0 0 0 0 0 159 0 0 0 0 0 0 0 0 0 0 0 0 0 0 602 603 604 605 606 607 608 609 610 0 0 0 0 0 0 0 0 0 0 0 0 0 0 0 0 0 0 0 380 381 0 0 0 0 0 0 0 0 0 
0 0 0 0 0 0 0 0 0 0 0 0 0 0 0 0 0 0 0 0 0 0 0 0 0 0 0 0 0 0 0 0 0 0 0 0 0 0 0 0 0 0 0 0 0 0 210 0 0 0 0 0 0 0 0 0 0 0 0 0 0 653 654 655 656 657 658 659 660 661 662 0 0 0 0 0 0 0 0 0 0 0 0 0 0 0 0 0 430 431 432 0 0 0 0 0 0 0 0 0 
0 0 0 0 0 0 0 0 0 0 0 0 0 0 0 0 0 0 0 0 0 0 0 0 0 0 0 0 0 0 0 0 0 0 2304 2306 0 0 0 0 0 0 0 0 0 0 261 0 0 0 0 159 0 0 0 0 0 0 0 0 0 0 705 706 707 708 709 710 711 712 713 0 0 0 0 0 0 0 0 163 162 162 167 166 166 167 165 163 481 482 483 167 0 0 0 0 0 0 0 0 
0 0 0 0 0 0 0 0 0 0 0 0 0 0 0 0 0 0 0 0 0 0 0 0 0 0 0 0 0 0 0 1598 2305 2354 2355 2357 0 0 0 0 0 0 0 0 0 0 210 0 0 0 0 210 0 0 0 0 0 0 0 0 0 0 756 757 758 759 760 761 762 763 764 0 0 0 0 0 0 0 0 219 371 372 373 372 373 372 372 372 370 371 372 373 0 0 0 0 0 0 0 0 
0 0 0 0 0 0 0 0 0 0 0 0 0 0 0 0 0 0 0 0 0 0 0 0 0 0 0 0 0 2354 2355 2453 2454 2355 1152 2356 2357 2305 2304 2304 0 0 0 0 0 0 261 0 0 0 0 261 0 0 0 0 0 0 0 0 0 0 0 0 0 810 811 812 813 0 0 0 0 0 0 0 0 0 270 271 271 364 365 266 268 264 267 269 265 265 221 222 0 0 0 0 0 0 0 0 
0 0 0 0 0 0 0 0 2203 2204 2204 2204 2204 2205 2206 0 0 0 0 0 0 0 0 0 0 0 0 0 0 2354 1300 1152 1197 992 1152 1152 1152 2453 2454 2356 2357 2403 2404 2402 2304 2305 312 0 0 0 0 210 0 0 0 0 0 0 0 0 0 0 0 0 0 861 0 0 0 0 0 0 0 0 0 0 0 0 0 0 0 415 416 418 420 270 267 267 371 422 272 273 0 0 0 0 0 0 380 381 
0 0 0 0 0 2203 2204 2205 2254 2255 2255 2255 2255 2256 2257 2205 2204 2204 2204 2204 2204 2206 0 0 2303 2304 2305 2403 2404 2354 1351 1152 1197 992 991 1146 1146 1145 1152 1152 1152 2453 2453 2454 2454 2453 2454 2357 0 0 0 261 0 0 0 0 0 0 0 0 0 2265 0 0 0 912 0 0 0 0 0 162 163 164 165 162 163 164 165 166 167 0 0 0 0 0 270 268 421 416 0 0 0 0 0 0 0 430 431 432 
2102 2102 2103 0 2203 2254 2255 2256 2256 1152 991 1146 1152 1152 2255 2256 2255 2255 2255 2255 2255 2257 0 0 2354 2355 2453 2453 2356 2355 1351 1152 1145 1196 991 1146 991 941 1152 1152 1152 941 1152 1152 1152 1458 1406 1407 0 0 0 312 2297 2298 2299 2297 2298 2299 0 0 0 2316 0 0 0 963 0 0 0 0 0 1152 1152 1152 1152 1152 1152 1152 1152 1152 1152 0 0 0 0 0 0 417 418 0 0 167 164 165 166 164 164 481 482 483 
2153 2153 2154 0 2254 2004 940 940 1197 1145 1197 991 991 991 1152 1152 941 941 940 940 1152 2257 0 0 2354 1351 1196 1152 1152 1152 1152 1152 1152 941 1152 1152 940 1145 991 1197 1146 1197 940 1152 1152 1456 0 0 0 0 2152 2153 2352 2153 2153 2352 2153 2350 0 0 0 2367 0 0 0 1014 0 0 0 0 0 0 0 0 0 0 0 0 0 0 0 0 0 0 0 0 0 0 0 0 0 219 214 215 213 214 215 216 217 218 
991 1146 941 0 2254 1152 1145 1196 992 1146 992 1146 992 1197 940 1196 1197 992 1197 941 1152 2257 0 0 2354 1351 991 1145 1146 1196 1196 991 991 941 1197 1152 1152 941 940 992 1146 1152 1152 1152 1458 1507 0 0 0 0 887 1152 940 1146 991 1152 1152 1197 2352 2352 2153 2153 2352 2352 2153 2153 2350 0 0 0 0 0 0 0 0 0 422 423 424 0 0 0 0 0 0 0 0 0 0 0 0 415 367 369 370 371 372 373 365 366 
1152 991 941 0 2254 1152 1146 1146 1146 1196 1197 992 1197 991 1146 1146 940 991 1145 1196 1152 2257 0 0 2354 1300 1152 992 1197 1196 941 941 1196 1152 1196 1146 1146 992 940 1145 1196 1152 1152 1406 1407 0 0 0 0 0 989 1152 1152 1152 1152 992 991 1196 991 1152 992 1152 1145 1152 992 992 990 0 0 0 0 0 0 0 0 0 0 0 0 0 0 0 0 0 0 0 0 0 0 0 0 0 417 267 413 414 421 422 423 424

0 531 0 0 0 0 0 0 0 359 307 308 309 0 0 0 0 0 0 0 0 0 0 0 0 0 0 0 0 0 0 0 0 0 0 260 0 0 0 0 0 0 0 0 0 0 0 0 0 0 0 0 0 0 0 0 0 0 0 0 0 0 0 0 0 0 0 0 0 0 0 0 0 0 0 0 0 0 0 0 0 0 0 0 0 0 0 0 0 0 0 0 0 0 0 0 0 0 0 0 
0 582 0 0 0 0 0 0 0 0 0 0 0 0 0 0 0 0 0 0 0 0 0 0 0 0 0 0 0 0 0 0 0 0 0 1622 1623 0 0 0 0 0 0 0 0 0 0 0 0 0 0 0 0 0 0 0 0 0 0 0 0 0 0 0 0 0 0 0 0 0 0 0 0 0 0 0 0 0 0 0 0 0 0 0 0 0 175 176 177 178 179 0 0 0 0 0 0 0 0 0 
0 633 0 0 0 0 0 0 0 0 0 0 0 0 0 0 0 0 0 0 0 0 0 0 0 0 0 0 0 0 0 0 0 0 0 1673 1674 0 0 0 0 0 0 0 0 0 0 0 0 0 0 0 0 0 0 0 0 0 0 0 0 0 0 0 0 0 0 0 0 0 0 0 0 0 0 0 1620 1621 206 0 0 0 0 0 0 0 226 227 228 229 230 231 0 0 0 0 0 0 0 0 
0 684 0 0 0 0 0 0 0 0 0 0 0 0 0 0 0 0 0 0 0 0 0 0 0 0 0 0 0 0 0 0 0 0 0 1724 1725 0 0 0 0 0 0 0 0 0 0 0 0 0 0 0 0 293 0 0 0 0 0 0 0 0 0 0 0 0 0 0 0 0 0 0 0 0 0 0 1671 1672 0 0 0 0 0 0 0 0 277 278 279 280 281 282 283 0 0 0 0 0 0 0 
0 735 0 0 0 0 0 0 0 0 0 0 0 0 0 0 0 0 0 0 0 0 0 0 0 0 0 0 0 0 0 0 0 0 0 1775 1776 0 0 0 0 0 0 0 0 0 0 0 0 0 0 0 0 344 0 0 0 0 0 0 0 0 0 0 0 0 0 0 0 0 0 0 0 0 0 0 1722 1723 0 0 0 0 0 0 0 0 0 0 330 331 332 333 0 0 0 0 0 0 0 0 
0 786 0 0 0 0 0 0 0 0 0 0 0 0 0 0 0 0 0 0 0 0 0 0 0 0 0 0 0 0 490 491 492 0 161 0 0 0 0 0 0 0 0 0 0 0 211 0 0 0 0 0 394 395 396 0 0 0 0 0 0 0 0 0 0 0 0 0 0 0 0 0 0 0 0 0 1773 1774 0 0 0 0 0 0 0 0 0 0 0 0 0 0 0 0 0 0 0 0 0 0 
0 0 0 0 0 0 0 0 0 0 0 0 0 0 0 0 0 0 0 0 0 0 0 0 0 0 0 0 0 0 541 542 543 0 212 0 0 0 0 2120 0 0 0 0 0 0 211 0 0 0 0 0 445 446 447 0 0 0 0 0 0 0 0 0 0 0 0 0 0 0 0 893 894 895 896 897 0 0 0 411 412 0 0 0 0 0 0 383 384 385 386 387 0 0 0 0 22 23 24 25 
0 0 0 0 0 0 0 0 0 0 0 0 0 0 0 0 0 0 0 0 0 0 0 0 0 0 0 0 0 1596 1597 593 0 0 0 0 0 7 0 2171 2172 0 0 0 0 0 262 0 0 0 0 211 496 497 498 0 0 0 0 0 0 0 0 0 0 0 0 0 0 0 943 944 945 946 947 948 0 0 162 1719 1717 1715 1716 1718 1716 1716 1719 1715 1718 1714 1715 1716 0 0 0 0 73 74 75 76 
0 0 0 0 0 0 0 0 0 0 0 0 0 2166 2164 0 0 0 0 0 0 0 0 0 0 0 0 0 1444 1445 1446 1447 2358 2359 2360 0 0 4 4 2222 2223 2271 2272 2062 2063 0 0 0 0 0 0 211 547 548 549 550 0 0 0 0 0 0 863 864 865 866 0 0 0 0 994 995 996 997 998 999 0 0 1717 0 0 0 0 0 0 0 0 0 0 0 0 0 0 0 0 0 124 125 126 127 
0 0 0 0 0 0 0 0 2412 2413 0 0 0 2217 2215 0 16 17 0 0 2164 0 0 0 0 2060 2061 0 0 0 0 0 0 0 0 0 0 0 0 0 2304 2322 2323 2113 2114 410 411 412 0 0 0 597 598 599 600 601 0 0 0 0 0 0 914 915 916 917 918 0 0 0 0 208 1047 1048 0 0 0 0 0 0 0 0 0 0 0 0 0 0 0 0 0 0 0 0 0 0 0 0 0 0 
2118 2119 0 0 0 2213 2214 0 2463 2464 0 0 0 0 0 0 67 68 0 2216 2215 0 0 0 0 2111 2112 0 0 0 0 0 0 0 0 0 0 0 0 0 1607 0 0 0 0 0 0 0 0 0 0 648 649 650 651 652 0 0 0 0 0 0 965 966 967 968 969 0 0 0 0 259 1098 1099 1100 0 0 0 23 24 25 0 0 0 0 0 0 0 0 0 0 0 0 0 2409 0 0 0 0 0 
2169 2170 0 0 2069 0 0 0 0 0 0 0 0 0 0 0 0 0 0 0 0 0 0 0 0 0 0 0 0 0 0 0 0 0 0 0 0 0 0 0 0 0 0 0 0 0 0 0 0 0 409 410 411 701 0 0 0 2067 0 0 0 0 1016 1017 1018 1019 1020 0 0 0 0 213 214 215 216 213 214 215 216 217 218 0 0 0 0 0 0 0 0 0 0 411 412 0 2460 0 120 121 122 123 
0 0 0 0 0 0 0 0 0 0 0 0 0 0 0 0 0 0 0 0 0 888 0 0 0 0 0 0 0 0 0 0 0 0 0 0 0 0 0 0 0 0 0 0 0 0 0 0 0 0 0 0 0 0 0 2258 2259 0 0 1596 1597 1598 0 0 1069 483 0 0 0 0 0 264 265 266 267 264 265 266 267 271 272 0 0 0 0 0 0 0 0 0 0 1715 0 0 0 0 0 0 0 0 
0 0 0 0 0 0 0 0 0 0 0 0 0 0 0 0 0 0 0 0 0 939 0 0 0 0 0 0 0 0 0 0 0 0 0 0 0 0 0 0 0 0 0 0 0 0 0 0 0 0 0 0 0 0 0 0 0 0 0 0 0 0 0 0 0 0 0 0 0 0 0 415 416 418 415 422 422 423 424 0 0 0 0 0 0 0 0 0 0 0 0 0 0 0 0 0 0 0 0 0 
0 0 0 0 0 0 0 0 0 0 0 0 0 0 0 0 0 0 0 0 0 1245 0 0 0 0 0 0 0 0 0 0 0 0 0 0 0 0 0 0 0 0 0 0 0 0 0 0 0 0 0 0 0 0 0 0 0 0 0 0 0 0 0 0 0 0 0 0 0 0 0 0 0 0 0 417 418 419 273 0 0 0 0 0 0 0 0 0 0 0 0 0 0 0 0 0 0 0 0 0

0 0 0 0 0 0 0 0 0 0 0 0 0 0 0 0 0 0 0 0 0 0 0 0 0 0 0 0 0 0 0 0 0 0 0 0 0 0 0 0 0 0 0 0 0 0 0 0 0 0 0 0 0 0 0 0 0 0 0 0 0 0 0 0 0 0 0 0 0 0 0 0 0 0 0 0 0 0 0 0 0 0 0 0 0 0 0 0 0 0 0 0 0 0 0 0 0 0 0 0 
0 0 0 0 0 0 0 0 0 0 0 0 0 0 0 0 0 0 0 0 0 0 0 0 0 0 0 0 0 0 0 0 0 0 0 0 0 0 0 0 0 0 0 0 0 0 0 0 0 0 0 0 0 0 0 0 0 0 0 0 0 0 0 0 0 0 0 0 0 0 0 0 0 0 0 0 0 0 0 0 0 0 0 0 0 0 0 0 0 0 0 0 0 0 0 0 0 0 0 0 
0 0 0 0 0 0 0 0 0 0 0 0 0 0 0 0 0 0 0 0 0 0 0 0 0 0 0 0 0 0 0 0 0 0 0 0 0 0 0 0 0 0 0 0 0 0 0 0 0 0 0 0 0 0 0 0 0 0 0 0 0 0 0 0 0 0 0 0 0 0 0 0 0 0 0 0 0 0 0 0 0 0 0 0 0 0 0 0 0 0 0 0 0 0 0 0 0 0 0 0 
0 0 0 0 0 0 0 0 0 0 0 0 0 0 0 0 0 0 0 0 0 0 0 0 0 0 0 0 0 0 0 0 0 0 2 0 0 0 0 0 0 0 0 0 0 0 0 0 0 0 0 0 0 0 0 0 0 0 0 0 0 0 0 0 0 0 0 0 0 0 0 0 0 0 0 0 0 0 0 0 0 0 0 0 0 0 0 0 0 0 0 0 0 0 0 0 0 0 0 0 
0 0 0 0 0 0 0 0 0 0 0 0 0 0 0 0 0 0 0 0 0 0 0 0 0 0 0 0 0 0 0 0 0 0 0 0 0 0 0 0 0 0 2 0 0 0 0 0 0 0 0 0 0 0 0 0 0 0 0 0 0 0 0 0 0 0 0 0 0 0 0 0 0 0 0 0 0 0 0 0 0 0 0 0 0 2 0 2 0 0 0 0 0 0 0 0 0 0 0 0 
0 0 0 0 0 0 0 0 0 0 0 0 0 0 0 0 0 0 0 0 0 0 0 0 0 0 0 0 0 0 0 0 0 0 0 0 0 0 0 0 0 0 0 0 0 0 0 0 0 0 0 0 0 0 0 0 2 0 0 0 0 0 0 0 0 0 0 0 0 0 0 0 0 0 0 0 0 0 0 0 0 0 0 0 0 0 0 0 0 0 0 0 0 0 0 0 0 0 0 0 
0 0 0 0 0 0 0 0 0 0 0 0 2 0 0 0 0 0 0 0 0 0 0 0 0 0 0 0 0 0 0 0 0 0 0 0 0 0 0 0 0 0 0 0 0 0 0 0 0 0 0 0 0 0 0 0 0 0 0 0 0 0 0 0 0 2 0 0 0 0 0 0 0 0 0 0 2 0 0 0 0 0 0 0 0 0 0 0 0 0 0 0 0 0 0 0 0 0 0 0 
0 0 0 0 0 0 2 0 0 0 0 0 0 0 0 0 0 0 0 0 0 0 0 0 0 0 0 0 0 0 0 0 0 1 1 1 0 0 0 0 0 0 0 0 0 0 0 0 0 0 0 0 0 0 0 0 0 0 0 0 0 0 0 0 0 0 0 0 0 0 0 0 0 0 0 0 0 0 0 1 1 1 1 1 1 1 1 1 1 1 1 1 0 0 0 0 0 0 0 0 
0 0 0 0 0 0 0 0 0 0 0 0 0 0 0 0 0 0 0 0 0 0 0 0 0 0 0 0 0 1 1 1 1 1 0 1 1 0 0 0 0 0 0 0 0 0 0 0 0 0 0 0 0 0 0 0 0 0 0 0 0 0 0 0 0 0 0 0 0 0 0 0 0 0 0 0 0 0 1 1 1 1 1 1 1 1 0 0 0 0 1 1 0 0 0 0 0 0 0 0 
0 0 0 0 0 0 0 0 0 0 0 0 0 0 0 0 0 0 0 0 0 0 0 0 0 0 0 0 0 1 0 0 0 0 0 0 1 1 1 1 1 0 0 0 0 0 0 0 0 0 0 0 0 0 0 0 0 0 0 0 0 0 0 0 0 0 0 0 0 0 0 0 0 0 0 0 0 0 0 0 0 1 1 1 0 1 1 0 0 1 1 0 0 0 0 0 0 0 0 0 
0 0 0 0 0 0 0 0 1 1 1 1 1 1 1 0 0 0 0 0 0 0 0 0 0 0 0 0 0 1 0 0 0 0 0 0 0 0 0 0 1 1 1 1 1 1 1 1 0 0 0 0 0 0 0 0 0 0 0 0 0 0 0 0 0 0 0 0 0 0 0 0 0 0 0 0 0 0 0 0 0 0 0 0 0 0 1 1 1 1 0 0 0 0 0 0 0 0 0 0 
0 0 0 0 0 1 1 1 1 0 0 0 0 0 1 1 1 1 1 1 1 1 0 0 1 1 1 1 1 1 0 0 0 0 0 0 0 0 0 0 0 0 0 0 0 1 1 1 0 0 0 0 0 0 0 0 0 0 0 0 0 0 0 0 0 0 0 0 0 0 0 1 1 1 1 1 1 1 1 1 1 0 0 0 0 0 0 1 1 0 0 0 0 0 0 0 0 0 0 0 
1 1 1 0 1 1 0 0 0 0 0 0 0 0 0 0 0 0 0 0 0 1 0 0 1 0 0 0 0 0 0 0 0 0 0 0 0 0 0 0 0 0 0 0 1 1 0 0 0 0 1 1 1 1 1 1 1 1 0 0 0 0 0 0 0 0 0 0 0 0 0 1 0 0 0 0 0 0 1 1 1 0 0 0 0 0 0 0 0 0 0 1 1 1 1 1 1 1 1 1 
0 0 1 0 1 0 0 0 0 0 0 0 0 0 0 0 0 0 0 0 0 1 0 0 1 0 0 0 0 0 0 0 0 0 0 0 0 0 0 0 0 0 0 1 1 0 0 0 0 0 1 0 0 0 0 0 0 1 1 1 1 1 1 1 1 1 1 0 0 0 0 1 1 1 1 1 0 0 1 0 0 0 0 0 0 0 0 0 0 0 0 1 1 0 0 0 0 0 0 0 
0 0 1 0 1 0 0 0 0 0 0 0 0 0 0 0 0 0 0 0 0 1 0 0 1 0 0 0 0 0 0 0 0 0 0 0 0 0 0 0 0 0 0 1 0 0 0 0 0 0 1 0 0 0 0 0 0 0 0 0 0 0 0 0 0 0 1 0 0 0 0 0 0 0 0 1 1 1 1 0 0 0 0 0 0 0 0 0 0 0 0 0 1 1 1 1 1 1 1 1
