4 15 100

0 0 0 0 0 0 0 0 0 0 0 0 0 0 0 0 0 0 0 0 0 0 0 0 0 0 0 0 0 0 0 0 0 0 0 0 0 0 0 0 0 0 0 501 502 503 504 505 0 0 0 0 0 0 0 0 0 0 0 0 0 0 0 0 0 0 0 0 0 0 0 0 0 0 2000 2000 2001 1950 1950 1950 2001 2001 2000 2001 2001 2001 2001 2001 2001 2001 2001 2001 2001 2001 1950 1950 1950 2001 1951 0 
0 0 0 0 0 0 0 0 0 0 0 0 1399 1400 0 0 0 0 0 0 0 0 0 0 0 0 0 0 0 0 0 0 0 0 0 0 0 0 0 0 0 0 551 552 553 554 555 556 557 0 0 0 0 0 0 0 0 0 0 0 0 0 0 0 0 0 0 0 0 0 0 0 0 0 0 2000 2001 1540 2001 2001 1949 1950 1950 2000 2001 2001 2001 2001 1950 1950 2001 2001 1950 2000 2001 2001 2001 2000 1951 0 
0 1246 1247 1248 0 0 0 0 0 0 0 0 0 1400 0 0 0 0 0 0 0 0 0 0 0 0 0 0 0 0 0 0 0 0 0 0 0 0 0 0 0 0 602 603 604 605 606 607 608 609 610 0 0 0 0 0 0 0 0 0 0 0 0 0 0 0 0 0 0 0 0 0 0 0 0 0 1897 1950 1950 2001 1949 1949 1950 1949 1950 1950 1950 2000 1492 2051 1592 1592 2001 1493 1950 1950 1949 2000 1951 0 
0 1297 1298 1299 0 0 0 0 0 0 0 0 0 1400 0 0 0 0 0 0 0 0 0 0 0 0 0 0 0 0 0 0 0 0 0 0 0 0 0 0 0 0 653 654 655 656 657 658 659 660 661 662 0 0 0 0 0 0 0 0 0 0 0 0 0 0 0 0 0 0 0 0 0 207 207 0 1948 1949 2001 2001 1949 1950 1950 1949 1492 2052 1592 2052 1593 0 0 0 0 1592 2051 2001 2000 2000 1593 0 
0 0 0 0 0 0 0 0 0 0 0 0 1450 1451 1452 0 0 0 0 0 0 0 0 0 0 0 0 0 0 0 0 0 0 0 0 0 0 0 0 0 0 0 0 705 706 707 708 709 710 711 712 713 0 0 0 0 0 0 0 0 0 0 0 0 0 0 0 0 0 0 0 0 0 0 0 0 1948 1950 2000 2001 1949 1949 1950 1949 1542 0 0 0 0 0 0 0 0 0 0 1948 2000 1542 0 0 
0 0 0 0 0 1191 1190 0 0 0 0 0 1399 1400 1401 0 0 0 0 0 0 0 0 0 0 0 0 0 0 0 0 0 0 0 0 0 0 0 0 0 0 0 0 756 757 758 759 760 761 762 763 764 0 0 0 0 0 0 0 0 0 0 0 0 0 0 40 41 42 0 0 0 0 0 0 0 1948 1950 1950 2001 1950 1950 1950 1949 1542 0 0 0 0 0 0 0 0 0 0 1540 2000 1951 0 0 
0 0 0 0 0 0 0 0 0 0 0 0 0 1451 0 0 0 0 0 0 0 0 0 0 0 0 0 0 0 0 0 0 0 0 0 0 0 0 0 0 0 0 0 0 0 809 810 811 812 813 0 0 0 0 0 0 0 0 0 0 0 0 0 0 0 0 91 92 93 94 95 0 0 0 0 0 1948 2001 1949 1949 1949 1950 1950 1949 1543 1490 1898 0 0 0 0 0 0 0 1708 1949 2000 1542 0 0 
0 0 0 0 0 0 0 0 0 1191 1191 0 0 1451 0 0 0 0 0 0 0 0 0 0 0 0 0 0 0 0 0 0 0 0 0 0 0 0 0 0 0 0 0 0 0 0 861 0 0 0 0 0 0 0 0 0 0 0 0 0 0 235 236 237 238 141 142 143 144 145 146 0 0 0 0 1897 1950 2001 1949 1950 1950 1950 1949 1949 1950 1949 1543 1899 1898 1898 1490 1490 1490 1899 1899 2000 2000 1542 0 0 
0 0 0 0 0 0 0 0 0 0 0 0 1450 1451 1452 0 0 0 0 0 0 0 0 0 0 0 0 0 0 0 0 0 0 0 0 0 0 0 0 0 0 0 0 0 0 0 912 0 0 0 0 0 0 0 0 0 0 0 0 0 0 286 287 288 289 192 193 194 195 196 197 0 0 0 0 1948 1949 2001 1949 1492 1592 1592 2051 1949 1949 1950 2000 2000 2000 2000 2000 2000 2000 2000 1949 2000 2001 1951 0 0 
0 0 0 0 0 0 0 0 0 0 0 0 1501 1502 1503 0 0 0 0 0 0 0 0 0 0 0 0 0 0 0 0 0 0 18 0 1596 1597 1598 0 0 0 0 0 0 0 0 963 0 0 0 52 53 54 55 56 57 0 0 0 0 0 337 338 339 340 243 244 245 246 247 0 1897 1898 1898 1899 1544 2001 2001 1950 1542 0 0 0 1948 1949 1949 1949 1949 1950 1949 1949 1949 1949 1949 2000 2000 2000 1951 2120 2121 
0 0 0 0 0 0 0 0 0 0 0 0 0 0 0 0 0 0 0 0 0 0 0 0 0 0 0 0 0 0 0 0 0 69 0 0 0 0 0 0 0 0 0 0 1596 1597 1014 0 0 1550 103 104 105 106 107 108 58 59 60 0 0 388 389 390 391 392 0 296 297 62 63 1948 1949 1950 1950 1950 1950 1951 2052 1593 0 0 0 0 1540 1592 2052 1949 1949 2000 2000 1949 1949 1949 1949 2000 1951 0 2171 2172 
0 0 0 0 0 0 0 0 0 0 0 0 0 0 0 0 0 1190 0 0 0 0 0 0 0 0 0 0 0 0 0 0 0 0 0 0 0 0 0 0 0 0 0 0 0 0 0 0 0 0 0 0 0 0 0 0 109 110 111 1596 1597 439 440 441 442 443 1597 347 115 113 114 1540 2000 2001 2001 2001 2001 1951 2102 0 0 0 0 0 0 0 0 1540 2000 2000 2001 2000 2000 2000 2000 2000 1542 0 2222 2223 
0 0 0 0 0 0 0 0 0 0 0 0 0 0 0 0 0 0 0 0 0 0 0 0 0 0 0 0 0 0 0 0 0 0 0 0 0 0 0 0 0 0 0 0 0 0 0 0 0 0 0 0 0 0 0 0 0 0 0 0 0 0 0 0 0 0 0 0 0 0 0 0 0 0 0 0 0 0 0 0 0 0 0 0 0 0 0 0 2000 2000 2001 0 0 2000 2001 0 0 0 0 0 
0 0 0 0 0 0 0 0 0 0 0 0 0 0 0 0 0 0 0 0 0 0 0 0 0 0 0 0 0 0 155 0 0 0 0 0 0 0 0 0 0 0 0 0 0 0 0 0 0 0 0 0 0 0 0 0 0 0 0 0 0 0 0 0 0 0 0 0 0 0 0 0 0 0 0 0 0 0 0 0 0 0 0 0 0 0 0 0 0 0 0 0 0 0 0 0 0 0 0 0 
0 0 0 0 0 0 0 0 0 0 0 0 0 0 0 0 0 0 0 0 0 0 0 0 0 0 0 0 0 0 307 308 308 360 0 0 0 0 0 0 0 0 0 0 0 0 0 0 0 0 0 0 0 0 0 0 0 0 0 0 0 0 0 0 0 0 0 0 0 0 0 0 0 0 0 0 0 0 0 0 0 0 0 0 0 0 0 0 0 0 0 0 0 0 0 0 0 0 0 0

0 0 0 0 0 0 0 0 0 0 0 0 0 2518 2471 2471 2471 2519 2470 2471 2470 2570 2471 2570 2471 2519 2470 2570 2470 2570 2571 0 0 0 0 0 0 0 0 0 0 0 0 0 0 0 0 0 1802 1390 1797 1441 1390 1441 1441 1339 1441 1796 1441 1797 1339 1390 1441 1390 1796 1390 1339 1797 1796 1390 0 0 0 0 0 0 0 0 0 0 0 0 0 0 0 0 0 0 0 0 0 0 0 0 0 0 0 0 0 0 
0 0 0 0 0 0 0 0 0 0 0 0 0 2569 2471 2570 2470 2570 2570 2519 2519 2570 2570 2519 2519 2570 2470 2471 2571 0 0 0 0 0 0 0 0 0 0 0 0 0 0 0 0 0 0 0 1853 1857 1857 1854 1855 1796 1339 1796 1441 1441 1441 1797 1441 1796 1441 1390 1339 1797 1390 1339 1339 1390 0 0 0 0 0 0 0 0 0 0 0 0 0 0 0 0 0 0 0 0 0 0 0 0 0 0 0 0 0 0 
0 0 0 0 0 0 0 0 0 0 0 0 0 0 0 0 0 2569 2570 2570 2519 2570 2519 2570 2570 2570 2571 0 0 0 0 0 0 0 0 0 0 0 0 0 0 0 0 0 0 0 0 0 0 0 0 0 1853 1856 1854 1854 1856 1855 1854 1855 1854 1857 1390 1390 1390 1390 1796 1441 1856 1854 0 0 0 0 0 0 0 0 0 0 0 0 0 0 0 0 0 0 0 0 0 0 0 0 0 0 0 0 0 0 
0 0 0 0 0 0 0 0 0 0 0 0 0 0 0 0 0 0 0 0 0 0 0 0 0 0 0 0 0 0 0 0 0 0 0 0 0 0 0 0 0 0 0 0 0 0 0 0 0 0 0 0 0 0 0 0 0 0 0 0 0 1853 1854 1854 1855 1856 1857 1855 0 0 0 0 0 1822 1823 0 0 0 0 0 0 0 0 0 0 0 0 0 0 0 48 49 50 0 0 0 0 0 0 0 
1685 1685 1685 1686 0 0 0 0 0 0 0 0 0 0 0 0 0 0 0 0 0 0 0 0 0 0 0 0 0 0 0 0 0 0 0 0 0 0 0 0 0 0 0 0 0 0 0 0 0 0 0 0 0 0 0 0 0 0 0 0 0 0 0 0 0 0 0 0 0 0 0 0 0 1873 1874 0 0 0 0 0 0 0 0 0 0 0 0 0 0 0 99 100 101 0 0 0 0 0 0 0 
1736 1736 1736 1841 1686 0 0 0 0 0 0 0 0 0 0 0 0 0 0 0 0 0 0 0 0 0 0 0 0 0 0 0 0 0 0 0 0 0 0 0 0 0 0 0 0 0 0 0 0 0 0 0 0 0 0 0 0 0 0 0 0 0 0 0 0 0 0 0 0 0 0 0 0 1924 1925 0 0 0 0 0 0 0 0 0 0 0 0 0 148 149 150 151 152 0 0 0 0 0 0 0 
1736 1736 1688 1689 1841 1685 1686 0 0 0 0 0 0 0 0 0 0 0 0 0 0 0 0 0 0 0 0 0 0 0 0 0 0 0 0 0 0 0 0 0 0 0 0 0 0 0 0 0 0 0 0 0 0 0 0 0 0 0 0 0 0 0 0 0 0 0 0 0 0 0 0 0 0 1975 1976 0 0 0 0 0 0 0 0 0 0 0 0 198 199 200 201 202 203 204 0 0 0 0 0 0 
1688 1689 1739 1740 1736 1736 1841 1685 1686 0 0 0 0 0 0 0 0 0 0 0 0 0 0 0 0 0 0 0 0 0 0 0 0 0 0 0 0 0 0 0 0 0 0 0 0 0 0 0 0 0 0 0 0 0 0 0 0 0 0 0 0 0 0 0 0 0 0 0 0 0 0 0 0 0 0 0 235 236 237 238 239 0 0 0 0 0 0 249 250 251 252 253 254 255 0 0 0 0 0 0 
1739 1740 1688 1689 1736 1736 1736 1736 1841 1685 1685 1686 0 0 0 0 0 0 0 0 0 0 0 0 0 0 0 0 0 0 0 0 0 0 17 0 0 0 0 0 0 0 0 0 0 0 0 0 0 0 0 0 0 0 0 0 0 0 0 0 0 0 0 0 0 0 0 0 0 0 0 0 0 0 0 0 286 287 288 289 290 0 0 0 0 0 0 300 301 302 303 304 305 306 0 0 0 0 0 0 
1736 1736 1739 1740 1736 1736 1736 1736 1736 1736 1841 1737 0 0 0 0 0 0 0 0 0 0 0 0 0 0 0 0 0 0 0 0 0 0 68 2101 2399 2501 2501 2501 2501 2502 2102 2299 0 0 0 0 0 0 0 0 0 0 0 0 0 0 0 0 0 0 0 0 0 0 0 0 0 0 0 0 0 0 0 0 337 338 339 340 341 0 0 0 0 0 0 0 352 353 354 355 0 0 0 0 0 0 0 0 
1736 1736 1736 1736 1736 1736 1736 1736 1124 1124 1124 1841 1685 1685 1686 0 0 0 0 0 0 0 0 0 0 0 0 0 0 0 0 0 0 0 68 2152 2348 2552 2552 2552 2552 2553 2451 2350 2102 2102 2102 2102 2102 2102 2102 2102 2102 2102 2103 2299 0 0 0 0 0 0 0 0 0 0 0 0 0 0 0 0 0 0 0 0 0 389 390 0 0 0 0 0 0 0 0 0 0 0 405 406 0 0 0 0 0 0 0 0 
1736 1736 1736 1736 1736 1484 1485 1736 1124 1124 1124 1124 1124 1124 1841 1685 1686 0 0 0 0 0 0 0 0 0 0 0 0 0 0 0 1693 1694 1694 1806 889 889 889 889 889 889 889 1095 2153 2153 2153 2153 2153 2153 2153 2153 2153 2153 2352 2350 2300 2300 2300 2300 2301 2302 2400 2501 2400 2103 2298 2501 2502 2297 2400 2300 2400 2301 2502 2501 2400 2501 441 2399 2300 2301 2501 2301 2102 2502 2297 2102 2103 2300 2102 457 2399 2400 2400 2301 2298 2102 2502 2301 
1736 1736 1736 1484 1485 1535 1536 1484 1485 1124 1124 1124 1124 1124 1124 1124 1841 1685 1685 1685 1685 1686 1546 0 0 0 0 0 0 0 0 0 0 1693 1390 1390 889 889 889 889 889 889 889 889 889 889 889 889 889 889 889 1095 1095 1095 1095 1152 2153 2153 2153 2153 2352 2353 2349 2353 2352 2353 2353 2349 2153 2556 2552 2552 2552 2552 2552 2552 2552 2552 2552 2552 2552 2552 2450 2553 2352 2348 2552 2552 2552 2349 2553 2154 2552 2552 2552 2553 2552 2552 2451 2553 
1736 1736 1736 1535 1536 1484 1485 1535 1536 1124 1124 1124 1124 1124 1124 1124 1124 1124 1124 1124 1124 1841 1686 0 0 0 0 0 0 0 0 0 0 1744 1390 1390 889 889 889 889 889 889 889 889 889 889 889 889 889 889 889 889 1095 1095 1095 1095 1095 1095 1095 1095 1095 1095 1095 1095 1095 1095 1095 1095 1095 1095 1095 1095 1095 1095 1095 1095 1095 1095 1095 1095 1095 1095 1095 1095 1095 1095 1095 1095 1095 1095 1095 1095 1095 1095 1095 1095 1095 1095 1095 1095 
1124 1124 1124 1124 1124 1535 1536 1484 1485 1124 1124 1124 1124 1124 1124 1124 1124 1124 1124 1124 1124 1124 1737 0 0 0 0 0 0 0 0 0 0 1744 1390 1390 889 889 889 1746 889 889 889 889 889 889 889 889 889 889 889 889 1095 1095 1095 1095 1095 1095 1095 1095 1095 1095 1095 1095 1095 1095 1095 1095 1095 1095 1095 1095 1095 1095 1095 1095 1095 1095 1095 1095 1095 1095 1095 1095 1095 1095 1095 1095 1095 1095 1095 1095 1095 1095 1095 1095 1095 1095 1095 1095

0 0 0 0 0 0 0 0 0 0 0 0 0 0 0 0 0 0 0 0 0 0 0 0 0 0 0 0 0 0 0 0 0 0 0 0 0 1155 1156 1157 1158 1159 1160 0 0 0 0 0 0 0 0 0 0 0 0 0 0 0 0 0 0 0 0 0 1404 1405 1457 1152 1152 1152 1356 1356 1356 1356 1356 1356 1356 1456 0 0 0 0 0 0 0 0 0 0 0 0 0 0 0 0 0 0 0 0 0 0 
0 0 0 0 0 0 0 0 0 0 0 0 0 0 0 0 0 0 0 0 0 0 0 0 0 0 0 0 0 1141 0 0 0 0 0 1204 1205 1206 1207 1208 1209 1210 1211 1212 0 0 0 0 0 0 0 0 1802 2260 2261 0 0 0 0 0 0 0 0 2263 2264 0 1508 1555 1556 1356 1356 1356 1356 1356 1356 1356 1458 1507 0 0 1105 1106 1107 1108 0 0 0 0 0 0 0 0 0 0 0 0 0 0 0 0 
0 0 0 0 0 0 0 0 0 0 0 0 0 0 0 1141 0 0 0 0 0 0 0 0 0 0 0 1141 0 0 0 0 0 0 0 1255 1256 1257 1258 1259 1260 1261 1262 1263 1264 0 0 0 0 0 0 0 0 0 0 0 0 0 0 0 0 1802 0 2314 0 0 0 1404 1405 1354 1354 1354 1354 1354 1354 1406 1407 0 0 1155 1156 1157 1158 1159 1160 0 0 0 0 0 0 0 0 0 0 0 0 0 0 0 
2248 2249 2248 2250 0 0 0 0 0 0 0 0 0 1728 0 0 0 0 1141 1141 0 0 0 0 1141 0 0 0 0 0 0 0 0 0 0 1306 1307 1308 1309 1310 1311 1312 1313 1314 1315 0 0 0 0 0 0 0 0 0 0 0 0 0 293 0 0 0 0 2307 2308 2309 0 0 0 0 0 0 0 0 0 0 0 1204 1205 1206 1207 1208 1209 1210 1211 1212 0 0 0 0 0 0 0 0 0 0 0 0 0 0 
0 0 0 0 2248 0 0 0 0 0 0 0 0 1779 0 0 0 0 0 0 0 0 0 0 0 0 0 0 0 0 0 0 0 0 0 1357 1358 1359 1360 1361 1362 1363 1364 1365 0 0 0 0 0 0 0 0 0 0 0 0 0 0 344 0 0 0 0 0 0 0 0 0 0 0 0 0 0 0 0 0 0 1255 1256 1257 1258 1259 1260 1261 1262 1263 1264 0 0 0 0 0 0 0 0 0 0 0 0 0 
0 0 0 0 0 0 0 0 0 0 0 0 0 0 0 0 0 0 0 0 0 0 0 0 0 0 0 0 0 0 0 0 0 0 0 0 1409 1410 1411 1412 1413 1414 1415 1416 0 0 0 0 0 0 0 0 0 0 0 0 0 394 395 396 0 0 0 0 0 0 0 0 0 0 0 0 0 0 0 0 0 1306 1307 1308 1309 1310 1311 1312 1313 1314 1315 0 0 0 0 0 0 752 0 0 0 0 0 0 
0 0 0 0 0 0 0 2249 2248 0 0 0 0 0 0 0 0 0 0 0 0 0 0 0 0 0 0 0 0 0 0 0 0 0 0 0 1460 1461 1462 1463 1464 1465 1466 1467 0 0 0 0 0 0 0 0 0 898 899 0 0 445 446 447 0 0 0 0 0 0 0 0 0 0 0 0 0 0 0 0 0 1357 1358 1359 1360 1361 1362 1363 1364 1365 0 0 0 0 0 0 802 803 804 805 0 0 0 0 
2374 0 0 0 0 0 0 0 0 0 0 2250 0 0 0 0 0 0 0 0 0 0 0 0 0 0 0 0 0 0 0 0 0 0 0 0 0 0 1513 1514 0 0 0 0 0 0 0 31 32 33 0 0 0 949 950 0 0 496 497 498 0 0 0 0 0 0 0 0 0 0 0 0 0 0 0 0 0 0 1409 1410 1411 1412 1413 1414 1415 1416 0 0 0 0 0 852 853 854 855 856 857 0 0 0 
2425 2373 2373 2374 2375 0 0 0 0 0 0 0 0 0 0 0 0 0 0 0 0 0 0 0 0 0 0 0 0 0 0 0 0 0 1730 0 0 0 1564 1565 0 2310 2311 2312 0 0 0 82 83 84 0 0 0 1000 1001 1002 0 547 548 549 550 0 0 0 0 0 0 0 0 0 0 0 0 0 0 0 0 0 1460 1461 1462 1463 1464 1465 1466 1467 0 0 0 0 902 903 0 905 906 0 0 0 0 0 
2424 2424 2424 2425 2426 0 0 0 0 0 0 0 0 2250 2248 0 0 0 0 0 0 0 0 0 0 0 0 0 0 0 0 0 2409 0 1781 0 2107 2108 2411 1616 0 2361 2362 2363 0 0 0 133 134 135 0 0 0 1051 1052 1053 597 598 599 600 601 0 0 0 490 491 492 0 0 0 0 0 0 0 0 0 0 0 0 0 1513 1514 0 0 0 0 0 0 2265 0 953 954 955 956 957 0 0 0 0 0 
2474 2474 2475 2476 2477 0 0 0 0 0 0 0 0 0 0 2250 2250 0 0 0 0 0 0 0 0 0 0 0 0 0 0 0 2460 0 0 0 0 0 0 0 0 0 0 0 0 1599 1600 1601 185 0 2067 1599 1600 1601 1103 0 648 649 650 651 652 0 0 0 541 542 543 0 0 0 0 0 0 0 0 0 0 0 0 0 1564 1565 0 0 0 0 0 0 2316 0 1004 1005 1006 1007 0 0 0 0 0 0 
2474 2474 2526 2527 2528 0 0 0 0 0 0 0 0 0 0 0 0 0 2245 2246 2247 2249 0 0 0 0 0 0 0 0 0 0 1444 1445 1446 1447 1338 0 0 0 0 0 0 0 0 0 0 0 0 0 0 0 0 0 0 0 2410 0 701 1552 1550 1551 1552 2412 2413 593 1596 1597 1598 2070 0 0 0 0 0 0 0 1596 1597 1598 1615 1616 0 0 0 0 0 0 2367 1596 1597 1598 1057 2267 0 0 0 1550 1551 1552 
2474 2527 2577 2578 2579 0 0 0 0 0 0 0 0 0 0 0 0 0 0 0 0 0 736 737 738 739 740 741 742 743 744 0 1744 1745 1746 0 1339 1337 1338 0 0 0 0 0 0 0 0 0 0 0 0 0 0 0 0 1449 0 0 0 0 0 0 0 2463 2464 0 0 0 0 0 0 0 0 0 0 0 0 0 0 0 0 0 0 0 0 0 0 0 0 0 0 0 0 0 0 0 0 0 0 0 
2577 2578 0 0 0 0 0 0 0 0 0 0 0 0 0 0 0 0 0 0 0 0 0 788 789 790 791 792 793 794 795 0 1744 1694 1695 1390 1390 1390 1704 1649 0 0 0 0 0 0 0 0 0 0 0 0 0 0 0 0 0 0 0 0 0 0 0 0 0 0 0 0 0 0 0 0 0 0 0 0 0 0 0 0 0 0 0 0 0 0 0 0 0 0 0 0 0 0 0 0 0 0 0 0 
0 0 0 0 0 0 0 0 0 0 0 0 0 0 0 0 0 0 0 0 0 0 838 839 840 841 842 843 844 845 846 0 1744 1745 1746 0 1390 1390 1390 0 1338 0 0 0 0 0 0 0 0 0 0 0 0 0 0 0 0 0 0 0 0 0 0 0 0 0 0 0 0 0 0 0 0 0 0 0 0 0 0 0 0 0 0 0 0 0 0 0 0 0 0 0 0 0 0 0 0 0 0 0

0 0 0 0 0 0 0 0 0 0 0 0 0 1 0 0 0 0 0 0 0 0 0 0 0 0 0 0 1 1 1 0 0 0 0 0 0 0 0 0 0 0 0 0 0 0 0 0 0 0 0 0 0 0 0 0 0 0 0 0 0 0 0 0 1 1 1 0 0 0 0 0 0 0 0 0 0 1 0 0 0 0 0 0 0 0 0 0 0 0 0 0 0 0 0 0 0 0 0 0 
0 0 0 0 0 0 0 0 0 0 0 0 0 1 1 1 1 1 0 0 0 0 0 0 0 0 1 1 1 0 0 0 0 0 0 0 0 0 0 0 0 0 0 0 0 0 0 0 0 0 0 0 0 0 0 0 0 0 0 0 0 0 0 0 0 0 1 1 0 0 0 0 0 0 0 0 1 1 0 0 0 0 0 0 0 0 0 0 0 0 0 0 0 0 0 0 0 0 0 0 
0 0 0 0 0 0 0 0 0 0 0 0 0 0 0 0 0 1 1 1 1 1 1 1 1 1 1 0 0 0 0 0 0 0 0 0 0 0 0 0 0 0 0 0 0 0 0 0 0 0 0 0 0 0 0 0 0 0 0 0 0 0 0 0 0 0 0 1 1 1 1 1 1 1 1 1 1 0 0 0 0 0 0 0 0 0 0 0 0 0 0 0 0 0 0 0 0 0 0 0 
0 0 0 0 0 0 0 0 0 0 0 0 0 0 0 0 0 0 0 0 0 0 0 0 0 0 0 0 0 0 0 0 0 0 0 0 0 0 0 0 0 0 0 0 0 0 0 0 0 0 0 0 0 0 0 0 0 0 0 0 0 0 0 0 0 0 0 0 0 0 0 0 0 0 0 0 0 0 0 0 0 0 0 0 0 0 0 0 0 0 0 0 0 0 0 0 0 0 0 0 
1 1 1 1 0 0 0 0 0 0 0 0 0 0 0 0 0 0 0 0 0 0 0 0 0 0 0 0 0 0 0 0 0 0 0 0 0 0 0 0 0 0 0 0 0 0 0 0 0 0 0 0 0 0 0 0 0 0 0 0 0 0 0 0 0 0 0 0 0 0 0 0 0 0 0 0 0 0 0 0 0 0 0 0 0 0 0 0 0 0 0 0 0 0 0 0 0 0 0 0 
0 0 0 1 1 0 0 0 0 0 0 0 0 0 0 0 0 0 0 0 0 0 0 0 0 0 0 0 0 0 0 0 0 0 0 0 0 0 0 0 0 0 0 0 0 0 0 0 0 0 0 0 0 0 0 0 0 0 0 0 0 0 0 0 0 0 0 0 0 0 0 0 0 0 0 0 0 0 0 0 0 0 0 0 0 0 0 0 0 0 0 0 0 0 0 0 0 0 0 0 
0 0 0 0 1 1 1 0 0 0 0 0 0 0 0 0 0 0 0 0 0 0 0 0 0 0 0 0 0 0 0 0 0 0 0 0 0 0 0 0 0 0 0 0 0 0 0 0 0 0 0 0 0 0 0 0 0 0 0 0 0 0 0 0 0 0 0 0 0 0 0 0 0 0 0 0 0 0 0 0 0 0 0 0 0 0 0 0 0 0 0 0 0 0 0 0 0 0 0 0 
0 0 0 0 0 0 1 1 1 0 0 0 0 0 0 0 0 0 0 0 0 0 0 0 0 0 0 0 0 0 0 0 0 0 0 0 0 0 0 0 0 0 0 0 0 0 0 0 2 2 0 0 0 0 0 0 0 0 0 0 0 0 0 0 0 0 0 0 0 0 0 0 0 0 0 0 0 0 0 0 0 0 0 0 0 0 0 0 0 0 0 0 0 0 0 0 0 0 0 0 
0 0 0 0 0 0 0 0 1 1 1 1 0 0 0 0 0 0 0 2 0 0 0 0 0 0 0 0 0 0 0 0 0 0 0 0 0 0 0 0 0 0 0 0 0 0 0 0 0 0 0 0 0 0 0 0 0 0 0 0 0 0 0 0 0 0 0 0 2 0 0 0 0 0 0 0 0 0 0 0 0 0 2 0 0 0 0 0 0 0 0 0 0 0 0 2 0 0 0 0 
0 0 0 0 0 0 0 0 0 0 0 1 0 0 0 0 0 0 0 0 0 0 0 0 0 0 0 0 0 0 0 0 0 0 0 0 0 0 0 0 0 0 0 0 0 0 0 0 0 0 0 0 0 0 0 0 0 0 0 0 0 0 0 0 0 0 0 0 0 0 0 0 0 0 0 0 0 0 0 0 0 0 0 0 0 0 0 0 0 0 0 0 0 0 0 0 0 0 0 0 
0 0 0 0 0 0 0 0 0 0 0 1 1 1 1 0 0 0 0 0 0 0 0 0 0 0 0 0 0 0 0 0 0 0 0 1 1 1 1 1 1 1 1 1 0 0 0 0 0 0 0 0 0 0 0 0 0 0 0 0 0 0 0 0 0 0 0 0 0 0 0 0 0 0 0 0 0 0 0 0 0 0 0 0 0 0 0 0 0 0 0 0 0 0 0 0 0 0 0 0 
0 0 0 0 0 0 0 0 0 0 0 0 0 0 1 1 1 0 0 0 0 0 0 0 0 0 0 0 0 0 0 0 1 1 1 1 0 0 0 0 0 0 0 1 1 1 1 1 1 1 1 1 1 1 1 1 0 0 0 0 0 0 0 0 0 0 0 0 0 0 0 0 0 0 0 0 0 0 0 0 0 0 0 0 0 0 0 0 0 0 0 0 0 0 0 0 0 0 0 0 
0 0 0 0 0 0 0 0 0 0 0 0 0 0 0 0 1 1 1 1 1 1 0 0 0 0 0 0 0 0 0 0 1 0 0 0 0 0 0 0 0 0 0 0 0 0 0 0 0 0 0 0 0 0 0 1 1 1 1 1 1 1 1 1 1 1 1 1 1 1 1 1 1 1 1 1 1 1 1 1 1 1 1 1 1 1 1 1 1 1 1 1 1 1 1 1 1 1 1 1 
0 0 0 0 0 0 0 0 0 0 0 0 0 0 0 0 0 0 0 0 0 1 1 0 0 0 0 0 0 0 0 0 1 0 0 0 0 0 0 0 0 0 0 0 0 0 0 0 0 0 0 0 0 0 0 0 0 0 0 0 0 0 0 0 0 0 0 0 0 0 0 0 0 0 0 0 0 0 0 0 0 0 0 0 0 0 0 0 0 0 0 0 0 0 0 0 0 0 0 0 
0 0 0 0 0 0 0 0 0 0 0 0 0 0 0 0 0 0 0 0 0 0 1 1 1 1 1 1 1 1 1 0 1 0 0 0 0 0 0 0 0 0 0 0 0 0 0 0 0 0 0 0 0 0 0 0 0 0 0 0 0 0 0 0 0 0 0 0 0 0 0 0 0 0 0 0 0 0 0 0 0 0 0 0 0 0 0 0 0 0 0 0 0 0 0 0 0 0 0 0