4 15 100

2144 1892 1893 2144 2144 2144 2144 0 0 0 0 0 2166 0 0 0 0 0 0 0 0 0 0 0 0 0 0 0 0 0 0 0 0 0 0 0 0 0 0 0 0 0 0 0 0 0 0 0 0 0 0 0 0 0 0 0 0 0 0 0 0 0 0 0 0 0 0 0 0 0 0 0 0 0 0 0 0 0 0 0 0 0 0 0 0 0 0 0 0 0 0 0 0 0 0 0 0 0 0 0 
2144 1943 1944 2144 2195 2195 2195 0 0 0 0 0 2217 0 0 0 0 0 0 0 0 0 0 0 0 0 0 0 359 360 360 307 308 309 0 0 0 0 0 0 0 0 358 0 0 0 0 0 0 0 0 0 0 0 0 0 0 0 0 0 0 0 0 0 0 0 0 0 0 0 0 0 0 0 0 0 0 0 0 0 0 0 0 0 0 0 0 0 0 0 0 0 0 0 0 0 0 0 0 0 
2144 2144 2144 1896 0 1764 1864 1865 0 0 0 0 0 0 0 0 0 0 0 0 0 0 308 308 308 0 308 308 308 308 308 309 0 0 0 0 0 0 0 0 0 358 0 0 0 0 0 0 0 0 0 0 0 0 0 0 0 0 0 0 0 0 0 0 0 0 0 0 1247 0 0 0 0 0 0 0 0 0 0 0 0 0 0 0 0 0 0 0 0 0 0 0 0 0 0 0 0 0 0 0 
2096 2097 1896 1813 0 1815 0 0 0 0 0 0 0 0 0 0 0 0 0 0 0 0 0 2217 0 0 0 0 0 0 0 0 0 0 0 0 0 0 0 0 0 0 0 0 0 0 0 0 0 0 0 0 0 0 0 0 0 0 0 0 0 0 0 0 0 0 0 1297 1298 1299 0 0 0 0 0 0 0 0 0 0 0 0 0 0 0 0 0 0 0 0 0 0 0 0 0 0 0 0 0 2250 
2147 2148 1896 0 0 1815 0 0 0 0 0 0 0 0 0 0 0 0 0 0 0 0 0 0 0 0 0 0 0 0 0 0 0 0 0 0 0 0 0 0 0 0 0 0 0 0 0 0 0 0 0 0 0 0 0 0 0 0 0 0 0 0 0 0 0 0 0 0 0 0 0 0 0 0 0 0 0 0 0 0 0 0 0 0 0 0 0 0 0 0 0 0 0 0 2249 2248 2249 2250 2249 0 
2144 2048 259 0 0 1866 0 0 0 0 0 0 0 0 0 0 0 0 0 0 0 0 0 0 0 0 0 0 0 0 0 0 0 0 0 0 0 0 0 0 0 0 0 0 0 0 0 0 0 0 0 0 0 0 0 0 0 0 0 0 0 0 0 0 0 1247 0 0 0 0 0 0 0 0 0 0 0 0 0 0 0 0 0 0 0 0 0 0 0 0 0 2250 2248 2249 0 0 0 0 0 0 
2144 1941 259 0 0 1866 0 0 0 0 0 0 0 0 0 0 0 0 0 0 0 0 0 0 0 0 0 0 0 0 0 0 0 0 0 0 0 0 0 0 0 0 0 0 0 0 0 0 0 0 0 0 0 0 0 0 0 0 0 0 0 0 0 0 0 0 0 0 0 0 0 0 0 0 0 0 0 0 0 0 0 0 0 0 2250 2248 2249 2250 2250 2248 2250 0 0 0 0 0 0 0 0 0 
2144 1941 259 0 0 1866 0 0 0 0 0 0 0 0 0 0 0 0 0 0 0 0 0 0 0 0 0 0 0 0 0 0 0 0 0 0 0 0 0 0 0 0 0 0 0 0 0 0 0 0 0 0 0 0 0 0 0 0 2245 2246 2247 1247 0 0 0 0 0 0 0 0 0 0 0 0 0 0 0 0 0 0 0 0 0 0 0 0 0 0 0 0 0 0 0 0 0 0 0 0 0 0 
2144 1941 259 0 0 1866 0 0 308 308 308 0 308 308 308 307 0 0 0 0 0 0 0 0 0 0 0 0 0 0 0 0 0 0 0 0 0 0 0 0 0 0 0 0 0 0 0 0 0 0 0 0 0 0 0 0 0 0 0 0 0 0 0 0 0 0 0 0 0 0 0 0 0 0 0 0 0 0 0 0 0 0 0 0 0 0 0 0 0 0 0 0 0 0 0 0 0 0 0 0 
1991 1947 259 0 0 1815 0 0 0 307 0 4 5 4 5 358 0 0 0 0 0 0 0 0 0 0 0 0 0 0 0 0 0 0 0 0 0 0 0 0 0 0 0 0 1549 0 0 0 0 0 0 0 0 0 0 0 0 0 0 0 0 0 0 0 0 0 0 0 0 0 0 0 0 0 0 0 0 0 0 0 0 0 0 0 0 0 0 0 0 0 0 0 0 0 0 0 0 0 0 0 
0 0 259 0 0 1815 0 0 0 358 4 5 0 0 0 0 0 0 0 0 468 469 470 0 0 0 0 0 0 0 0 0 0 0 0 0 0 0 0 0 0 0 0 0 0 0 0 0 0 0 117 118 0 0 0 0 0 0 0 0 0 0 0 0 0 0 0 0 0 0 0 0 0 0 0 0 0 0 0 0 0 0 0 0 0 0 0 0 0 0 0 0 0 0 0 0 0 0 0 0 
0 0 259 0 0 0 0 0 0 0 0 0 0 0 0 0 0 0 0 0 519 520 521 0 0 0 0 0 0 0 0 0 0 0 0 0 0 0 0 0 0 0 307 308 0 0 0 0 0 0 0 0 0 0 0 0 0 0 0 0 0 0 0 0 0 0 0 0 0 0 0 0 0 0 0 0 0 0 0 0 0 0 0 0 0 0 0 0 0 0 0 0 0 0 0 0 0 0 0 0 
0 0 259 0 0 0 0 0 0 0 0 0 0 0 0 0 0 0 0 0 570 571 572 0 0 0 0 0 0 0 0 0 0 0 0 0 0 308 308 308 308 308 309 0 0 0 0 0 0 0 0 0 0 0 0 0 0 0 0 0 0 0 0 0 0 0 0 0 0 0 0 0 0 0 0 0 0 0 0 0 0 0 0 0 0 0 0 0 0 0 0 0 0 0 0 0 0 0 0 0 
0 0 259 0 0 0 0 0 0 0 0 0 0 0 0 0 0 0 0 0 621 622 637 638 615 616 617 613 614 0 0 0 0 0 0 0 0 0 0 637 638 639 0 0 0 0 0 0 0 0 0 0 0 0 0 0 0 0 0 0 0 0 0 0 0 0 0 0 0 0 0 0 0 0 0 0 0 0 0 0 0 0 0 0 0 0 0 0 0 0 0 0 0 0 0 0 0 0 0 0 
0 0 0 0 0 0 0 0 0 0 0 0 0 0 0 0 0 0 0 0 0 0 0 0 0 0 0 0 0 0 0 0 0 0 0 0 0 0 0 0 0 0 0 0 0 0 0 0 0 0 0 0 0 0 0 0 0 0 0 0 0 0 0 0 0 0 0 0 0 0 0 0 0 0 0 0 0 0 0 0 0 0 0 0 0 0 0 0 0 0 0 0 0 0 0 0 0 0 0 0

0 0 0 0 0 0 0 1124 1124 1124 1124 575 576 578 1124 1124 1124 1124 1124 1892 1893 1124 1124 1124 2096 2097 1124 1124 2195 2195 2195 2195 2195 2195 2146 2143 1124 1124 1124 1124 1124 1124 1124 1787 1787 1124 1124 2096 2097 1124 1124 1124 1124 1124 1124 1124 524 525 0 0 0 0 0 0 0 0 0 0 0 0 0 0 0 0 0 0 0 0 0 0 0 0 0 0 0 0 0 0 0 0 0 0 0 0 0 0 0 0 0 0 
0 0 0 0 0 0 0 2195 2195 1124 1124 626 628 629 1124 2195 1124 1124 1124 1943 1944 1124 528 522 523 2148 524 525 0 0 0 0 160 0 522 2194 2197 2197 2146 2146 2146 1787 525 0 0 522 523 2147 2148 1124 1124 1124 1124 1124 1787 525 0 0 0 0 0 0 0 0 0 0 0 0 0 0 0 0 0 0 0 0 0 0 0 0 0 0 0 0 0 0 0 0 0 0 0 0 0 0 0 0 0 0 0 0 
0 0 0 0 1813 1814 0 0 260 522 2195 2195 2195 2195 525 311 522 2195 1124 1124 1124 1124 579 573 574 1124 575 576 160 0 160 0 211 0 0 0 0 0 522 2197 525 0 0 0 0 0 522 523 1124 1124 1124 1124 524 525 0 0 0 0 0 0 0 0 0 0 0 0 0 0 0 0 0 0 0 0 0 0 0 0 0 0 0 0 0 0 0 0 0 0 0 0 0 0 1247 0 0 0 0 0 0 0 
0 0 0 1947 1813 1814 0 0 260 0 0 0 0 260 0 0 0 0 522 2195 1124 1124 630 631 625 1124 626 627 211 0 211 0 262 0 0 0 0 0 0 0 0 0 0 0 0 0 0 522 523 1787 1787 524 525 0 0 0 0 0 0 0 0 0 0 0 0 0 0 2248 2250 2249 2248 2248 2250 2250 2250 0 0 0 0 0 0 0 0 0 0 0 0 0 0 0 0 1399 1400 1401 0 0 0 0 0 0 
0 0 0 1864 1864 1865 0 0 260 0 0 0 0 260 0 0 0 0 0 0 522 1124 2096 2097 1124 2145 525 0 262 0 262 0 0 0 0 0 0 0 0 0 0 0 0 0 0 0 0 0 0 0 0 0 0 0 0 0 0 0 0 0 0 0 0 0 0 0 2248 1684 1685 1685 1685 1685 1685 1685 1686 2248 2248 2250 0 0 0 0 0 0 0 0 0 0 0 0 0 1450 1451 1452 0 0 0 0 0 1684 
0 0 1947 0 0 0 0 0 260 0 0 0 0 260 0 0 0 0 0 0 0 578 2147 2148 1124 579 0 0 0 0 0 0 0 0 0 0 0 0 0 0 0 0 0 0 0 0 0 0 0 0 0 0 0 0 0 0 0 0 0 0 0 0 0 0 2248 2250 1684 1844 1124 1124 1124 1124 1124 1124 1124 1685 1685 1686 2250 2249 2248 2250 0 0 0 0 0 0 0 0 0 1501 1502 1503 1684 1685 1685 1685 1685 1124 
0 0 0 0 0 0 0 0 260 0 0 0 0 260 0 0 0 0 0 0 0 522 2195 2195 2195 525 0 0 0 0 0 0 0 0 0 0 0 0 0 0 0 1480 1482 0 0 0 0 0 0 0 0 0 0 0 0 0 0 0 0 0 0 0 2250 2248 1684 1685 1844 1124 1124 1124 1124 1124 1124 1124 1124 1124 1124 1124 1685 1685 1685 1686 2250 2249 2245 2246 2247 0 0 0 0 1684 1838 1685 1124 1124 1124 1124 1124 1124 
0 0 0 0 0 0 0 0 260 0 468 469 470 260 2265 0 0 0 0 0 0 0 0 0 0 0 0 0 0 0 0 0 0 0 0 0 0 0 0 1480 1481 1639 1941 0 0 0 0 0 0 0 0 0 0 0 0 0 0 2248 2249 2250 0 2248 1684 1685 1844 1124 1124 1124 1124 1124 1124 1124 1124 1124 1124 1124 1124 1124 1124 1124 1124 1124 1685 1685 1838 1685 1838 1685 1838 1838 1838 1124 1124 1124 1124 1484 1485 1124 1688 1689 
0 0 308 307 308 308 308 308 260 0 519 520 521 260 2316 2317 0 0 0 0 0 0 0 0 0 0 0 0 0 0 0 0 0 0 0 411 412 1480 1481 1639 1991 1991 1992 0 0 0 0 0 0 0 0 0 0 0 2250 2248 2249 1684 1685 1685 1685 1685 1844 1124 1688 1689 1124 1124 1124 1124 1124 1124 1124 1124 1124 1688 1689 1124 1124 1124 1124 1124 1124 1124 1124 1124 1124 1124 1124 1124 1124 1124 1124 1124 1124 1535 1536 1124 1739 1740 
0 0 0 0 0 0 0 1888 1890 0 570 571 572 260 2367 2368 0 0 0 0 0 0 0 0 0 0 0 0 0 0 0 0 0 0 409 1480 1481 1639 1991 678 679 0 0 0 0 0 636 637 638 639 0 0 1480 1481 1481 1685 1685 1844 1124 1124 1124 1124 1124 1124 1739 1740 1124 1124 1688 1689 1124 1124 1124 1124 1124 1739 1740 1484 1485 1124 1124 1124 1688 1689 1124 1124 1124 1124 1124 1124 1124 1688 1689 1124 1124 1124 1124 1124 1124 1124 
0 0 0 0 0 0 1888 1946 1896 0 621 622 1888 1889 1889 1890 0 0 2164 0 0 0 0 0 465 466 467 460 461 0 0 0 0 0 1480 1639 678 679 0 0 0 0 0 0 1480 1481 1481 1481 1481 1482 0 1480 1124 1124 1124 1124 1124 1124 1124 1124 1124 1124 1124 1124 1124 1124 1484 1485 1739 1740 1124 1124 1124 1124 1124 1124 1124 1535 1536 1124 1124 1124 1739 1740 1124 1124 1124 1124 1124 1484 1485 1739 1740 1124 1124 1124 1124 1124 1124 1124 
0 0 0 0 1888 1889 1946 1124 1945 2042 2042 2042 1946 1124 1124 1945 1889 1890 2215 2216 0 0 0 0 516 517 518 511 512 0 0 0 0 409 1531 1124 729 730 0 0 0 0 0 0 1124 1688 1689 1124 1124 1124 1481 1124 1124 1124 1124 1124 1124 1688 1689 1124 1124 1688 1689 1124 1124 1124 1535 1536 1124 1124 1124 1124 1124 1124 1124 1124 1124 1124 1124 1124 1124 1124 1124 1124 1124 1124 1124 1124 1124 1535 1536 1124 1124 1124 1124 1124 1124 1124 1124 1124 
0 0 0 0 1939 1124 1124 1124 1124 2096 2097 1124 1124 1892 1893 1124 1124 1945 1891 1890 0 0 0 0 567 568 569 562 563 0 0 0 0 1480 1538 1124 780 781 0 0 0 2512 0 1480 1124 1739 1740 1124 1124 1688 1689 1124 1124 1484 1485 1124 1124 1739 1740 1484 1485 1739 1740 1124 1124 1124 1124 1124 1124 1124 1124 1124 1124 1124 1124 1124 1124 1124 1124 1124 1124 1124 1124 1124 1124 1124 1484 1485 1124 1124 1124 1124 1124 1124 1124 1124 1124 1124 1124 1124 
410 411 412 1888 1946 1124 1124 1124 1124 2147 2148 1124 1124 1943 1944 1124 1124 1124 1124 1945 1890 636 637 638 637 638 638 637 638 0 0 0 0 1939 1484 1485 1637 784 785 0 2562 2563 1480 1124 1124 1124 1124 1124 1124 1739 1740 1124 1124 1535 1536 1124 1124 1124 1124 1535 1536 1124 1124 1124 1124 1688 1689 1124 1124 1124 1124 1124 1124 1124 1124 1688 1689 1124 1124 1124 1124 1124 1124 1124 1124 1124 1535 1536 1124 1124 1124 1124 1124 1124 1124 1124 1124 1688 1689 1124 
1889 1889 1889 1946 1124 1124 1124 1124 1124 1124 1124 1124 1124 1124 1124 1124 1124 1124 1124 1124 1945 1889 1889 1889 1889 1889 1889 1889 1890 0 0 0 0 1939 1535 1536 1124 1637 1481 1481 1481 1481 1124 1124 1124 1124 1124 1124 1124 1124 1124 1124 1124 1124 1124 1124 1124 1124 1124 1124 1124 1124 1124 1124 1124 1739 1740 1124 1124 1124 1124 1124 1124 1124 1124 1739 1740 1124 1124 1124 1124 1124 1124 1124 1124 1124 1124 1124 1124 1124 1124 1124 1124 1124 1124 1124 1124 1739 1740 1124

0 0 0 0 0 0 0 0 0 0 0 0 0 0 0 0 0 0 0 0 0 0 0 0 0 0 0 0 0 0 0 0 0 0 0 0 0 0 0 0 0 0 0 0 0 0 0 0 0 0 0 0 0 0 0 0 0 0 0 0 0 0 0 0 0 0 0 0 0 0 0 0 667 668 669 0 0 0 0 0 0 0 0 0 0 0 0 0 0 0 0 0 0 0 0 0 0 0 0 0 
0 0 0 0 0 0 0 0 0 0 0 0 0 0 0 0 0 0 0 0 0 0 0 0 0 0 0 0 0 0 0 0 0 0 0 0 0 0 0 0 0 0 0 0 0 0 0 0 0 0 0 0 0 0 0 0 0 0 0 0 0 0 0 0 0 0 0 0 0 0 0 0 718 719 720 0 0 0 0 0 0 0 0 0 0 0 0 0 0 0 0 0 0 0 0 0 0 0 0 0 
0 0 0 0 0 0 0 0 1629 0 0 0 0 0 0 0 0 0 0 0 0 0 0 0 0 0 0 0 0 0 0 1629 0 0 0 0 0 0 0 0 0 0 307 0 0 0 0 0 0 0 0 0 0 0 0 0 0 0 0 0 0 0 0 0 0 0 0 0 0 0 0 0 769 770 771 0 0 0 0 0 673 674 675 0 0 0 0 0 0 0 0 0 0 0 0 0 0 0 0 0 
0 0 0 0 0 0 0 0 1680 0 0 0 0 1626 0 0 0 0 0 0 0 0 0 0 0 0 0 0 0 0 0 1680 0 0 0 0 0 0 0 0 0 307 307 0 0 0 0 0 0 0 0 0 0 0 0 0 0 0 0 0 0 0 0 0 0 0 0 0 0 0 0 0 820 821 822 0 0 0 0 0 724 725 726 0 0 0 0 0 0 0 0 0 0 0 0 0 0 0 0 0 
0 0 0 0 0 0 0 0 0 0 0 0 0 1677 0 0 0 0 0 0 0 0 0 0 0 0 0 0 0 0 0 0 0 0 0 0 0 0 0 0 0 358 358 0 0 0 0 0 0 0 0 0 0 0 0 0 0 0 0 0 0 0 0 0 0 0 0 0 0 0 0 0 0 0 0 0 0 0 0 0 775 776 777 0 0 0 0 0 0 0 0 0 0 0 0 0 0 0 0 0 
0 0 0 0 0 0 0 0 0 0 0 0 0 0 0 0 0 0 0 0 0 0 0 0 0 0 0 0 0 0 0 0 0 0 0 0 0 0 0 0 0 358 358 0 0 0 0 0 0 0 0 0 0 0 0 0 0 0 0 0 0 0 0 0 0 0 0 0 0 0 0 0 0 0 0 0 0 0 0 0 826 827 0 0 0 0 0 0 0 0 0 0 0 0 0 0 0 0 0 0 
0 0 0 0 0 0 0 0 0 0 0 0 0 0 0 0 0 0 0 0 0 0 0 0 0 0 0 0 0 0 0 0 0 0 0 0 0 0 0 0 0 0 0 0 0 0 0 0 0 0 0 0 0 0 0 0 0 0 0 0 0 0 0 0 0 0 0 0 0 0 0 0 0 0 0 0 0 0 0 0 0 0 0 0 0 0 0 0 0 0 0 0 0 0 0 0 0 0 0 0 
0 0 0 0 0 0 0 0 0 0 0 0 0 0 0 462 463 464 0 0 0 0 0 0 0 0 0 0 0 0 0 0 0 0 0 0 0 0 0 0 0 0 0 0 0 0 0 0 0 0 0 0 0 0 0 0 0 0 0 0 0 0 0 0 0 0 0 0 0 0 0 0 0 0 0 0 0 0 0 0 0 0 0 0 0 0 0 0 0 0 0 0 0 0 0 0 0 0 0 0 
0 0 0 1731 0 0 0 0 0 0 0 0 0 0 0 513 514 515 0 0 0 0 0 0 0 0 0 0 0 0 0 0 0 0 0 0 0 0 0 0 0 0 0 0 0 0 0 0 0 0 0 0 0 0 0 0 0 0 0 0 0 0 0 0 0 0 0 0 0 0 0 0 0 0 0 0 0 0 0 0 0 0 0 0 0 0 0 0 0 0 0 0 0 0 0 0 0 2371 2372 2373 
0 0 0 1782 0 0 0 0 0 0 0 0 0 2216 0 564 565 566 0 0 0 0 0 0 0 0 0 0 0 0 0 0 0 0 0 0 0 0 0 0 0 0 0 0 0 0 1495 1496 1497 1498 0 0 0 0 0 0 0 0 0 0 0 0 0 0 0 0 0 0 0 0 0 0 0 0 0 0 0 0 0 0 0 0 0 0 0 0 0 0 0 0 0 0 0 0 0 0 0 2422 2423 2424 
0 0 0 0 638 638 0 0 0 2213 2214 0 0 0 0 615 616 617 0 0 0 0 462 463 464 462 463 464 0 0 0 0 0 0 0 0 0 0 0 667 668 669 0 0 0 0 0 0 0 0 0 0 0 0 0 0 0 0 0 0 0 0 0 0 0 0 0 0 0 0 0 0 0 0 0 0 0 0 0 0 0 0 0 0 0 0 0 0 0 0 0 0 0 0 0 0 0 2473 2474 2373 
0 0 0 0 0 0 0 0 0 0 0 0 0 0 0 0 0 0 0 0 0 0 513 514 515 513 514 515 0 0 0 0 0 0 0 0 0 0 0 718 719 720 0 0 0 0 0 0 0 0 0 0 0 0 0 0 0 0 0 0 0 0 0 0 0 0 0 0 0 0 0 0 0 0 0 0 0 0 0 0 0 0 0 0 0 0 0 0 0 0 0 0 0 0 0 0 0 2473 2474 2424 
0 0 0 1549 0 0 0 0 0 0 0 0 0 0 0 0 0 0 0 0 0 0 564 565 566 564 565 566 0 0 0 0 0 0 0 0 0 0 0 769 770 771 0 0 0 0 0 0 0 0 0 0 0 0 0 0 0 0 0 0 0 0 0 0 0 0 0 0 0 0 0 0 0 0 0 0 0 0 0 0 0 0 0 0 0 0 0 0 0 0 0 0 0 0 0 0 0 2473 2474 2475 
639 637 638 0 0 0 0 0 0 0 0 0 0 0 0 0 0 0 0 0 0 0 615 616 617 615 616 617 0 0 0 0 0 0 0 0 0 0 0 820 821 822 0 0 0 0 0 0 0 0 0 0 0 0 0 0 0 0 0 0 0 0 0 0 0 0 0 0 0 0 0 0 0 0 0 0 0 0 0 0 0 0 0 0 0 0 0 0 0 0 0 0 0 0 0 0 0 2524 2525 2526 
0 0 0 0 0 0 0 0 0 0 0 0 0 0 0 0 0 0 0 0 0 0 0 0 0 0 0 0 0 0 0 0 0 0 0 0 0 0 0 0 0 0 0 0 0 0 0 0 0 0 0 0 0 0 0 0 0 0 0 0 0 0 0 0 0 0 0 0 0 0 0 0 0 0 0 0 0 0 0 0 0 0 0 0 0 0 0 0 0 0 0 0 0 0 0 0 0 2575 2576 2577

0 0 0 0 0 0 0 0 0 0 0 0 0 0 0 0 0 0 0 0 0 0 0 0 0 0 0 1 1 1 1 1 1 1 1 0 0 0 0 0 0 0 1 1 1 1 0 0 0 0 0 0 0 0 0 1 1 1 0 0 0 0 0 0 0 0 0 0 0 0 0 0 0 0 0 0 0 0 0 0 0 0 0 0 0 0 0 0 0 0 0 0 0 0 0 0 0 0 0 0 
0 0 0 1 1 1 1 1 1 1 0 0 0 0 1 1 1 0 0 0 0 0 0 0 0 0 1 1 0 0 0 0 0 0 1 1 1 1 1 0 1 1 1 0 0 1 1 0 0 0 0 0 0 1 1 1 0 0 0 0 0 0 0 0 0 0 0 0 0 0 0 0 0 0 0 0 0 0 0 0 2 0 0 0 0 0 0 0 0 0 0 2 0 0 0 0 0 0 0 0
0 0 0 1 0 0 0 0 0 1 1 1 1 1 1 0 1 1 1 0 0 0 0 0 0 0 1 0 0 0 0 0 0 0 0 0 0 0 1 1 1 0 0 0 0 0 1 1 0 0 0 0 1 1 0 0 0 0 0 0 2 0 0 0 0 0 0 0 0 0 0 0 0 0 0 0 0 0 0 0 0 0 0 0 0 0 0 0 0 0 0 0 0 0 0 0 0 0 0 0 
0 0 1 1 0 0 0 0 0 0 0 0 0 0 0 0 0 0 1 1 1 0 0 0 0 0 1 0 0 0 0 0 0 0 0 0 0 0 0 0 0 0 0 0 0 0 0 1 1 1 1 1 1 0 0 0 0 0 0 0 0 0 0 0 0 0 0 0 0 0 0 0 0 0 0 0 0 0 0 0 0 0 0 0 0 0 0 0 0 0 0 0 0 0 0 0 0 0 0 0 
0 0 1 0 0 0 0 0 0 0 0 0 0 0 2 0 0 0 0 0 1 1 0 0 0 1 1 0 0 0 0 0 0 0 0 0 0 0 0 0 0 0 0 0 0 0 0 0 0 0 0 0 0 0 0 0 0 0 0 0 0 0 0 0 0 0 0 1 1 1 1 1 1 1 1 0 0 0 0 0 0 0 0 0 0 0 0 0 0 0 0 0 0 0 0 0 0 0 0 1
0 1 1 0 0 0 0 0 0 0 0 0 0 0 0 0 0 0 0 0 0 1 0 0 0 1 0 0 0 0 0 0 0 0 0 0 0 0 0 0 0 0 0 0 0 0 0 0 2 0 0 0 0 0 0 0 0 0 0 0 0 0 0 0 0 0 1 1 0 0 0 0 0 0 1 1 1 1 0 0 0 0 0 0 0 0 0 0 0 0 0 0 0 0 1 1 1 1 1 1
1 1 0 0 0 0 0 0 0 0 0 0 0 0 0 0 0 0 0 0 0 1 1 1 1 1 0 0 0 0 0 0 0 0 0 0 0 0 0 0 0 1 1 0 0 0 0 0 0 0 0 0 0 0 0 0 0 0 0 0 0 0 0 0 1 1 1 0 0 0 0 0 0 0 0 0 0 1 1 1 1 1 0 0 0 0 0 0 0 0 0 1 1 1 1 0 0 0 0 0
1 0 0 0 0 0 0 0 0 0 0 0 0 0 0 0 0 0 0 0 0 0 0 0 0 0 0 0 0 0 0 0 0 0 0 0 0 0 0 1 1 1 0 0 0 0 0 0 0 0 0 0 0 0 0 0 0 0 0 0 0 0 1 1 1 0 0 0 0 0 0 0 0 0 0 0 0 0 0 0 0 1 1 1 1 1 1 1 1 1 1 1 0 0 0 0 0 0 0 0 
1 0 0 0 0 0 0 0 0 0 0 0 0 0 0 0 0 0 0 0 0 0 0 0 0 0 2 0 0 0 0 0 0 0 0 0 0 1 1 1 1 0 0 0 0 0 0 0 0 0 0 0 0 0 0 0 0 1 1 1 1 1 1 0 0 0 0 0 0 0 0 0 0 0 0 0 0 0 0 0 0 0 0 0 0 0 0 0 0 0 0 0 0 0 0 0 0 0 0 0
0 0 0 0 0 0 0 1 1 0 0 0 0 0 0 0 0 0 0 0 0 0 0 0 0 0 0 0 0 0 0 0 0 0 0 1 1 1 0 0 0 0 0 0 0 0 0 0 0 0 0 0 1 1 1 1 1 1 0 0 0 0 0 0 0 0 0 0 0 0 0 0 0 0 0 0 0 0 0 0 0 0 0 0 0 0 0 0 0 0 0 0 0 0 0 0 0 0 0 0 
0 0 0 0 0 0 1 1 1 0 0 0 1 1 1 1 0 0 0 0 0 0 0 0 0 0 0 0 0 0 0 0 0 0 1 1 1 0 0 0 0 0 0 0 1 1 1 1 1 1 0 1 1 0 0 0 0 0 0 0 0 0 0 0 0 0 0 0 0 0 0 0 0 0 0 0 0 0 0 0 0 0 0 0 0 0 0 0 0 0 0 0 0 0 0 0 0 0 0 0
0 0 0 0 1 1 1 0 1 1 1 1 1 0 0 1 1 1 0 0 0 0 0 0 0 0 0 0 0 0 0 0 0 0 1 0 1 0 0 0 0 0 0 0 1 0 0 0 0 1 1 1 0 0 0 0 0 0 0 0 0 0 0 0 0 0 0 0 0 0 0 0 0 0 0 0 0 0 0 0 0 0 0 0 0 0 0 0 0 0 0 0 0 0 0 0 0 0 0 0 
0 0 0 0 1 0 0 0 0 0 0 0 0 0 0 0 0 1 1 1 0 0 0 0 0 0 0 0 0 0 0 0 0 1 1 0 1 0 0 0 0 0 0 1 1 0 0 0 0 0 0 0 0 0 0 0 0 0 0 0 0 0 0 0 0 0 0 0 0 0 0 0 0 0 0 0 0 0 0 0 0 0 0 0 0 0 0 0 0 0 0 0 0 0 0 0 0 0 0 0 
0 0 0 1 1 0 0 0 0 0 0 0 0 0 0 0 0 0 0 1 1 0 0 0 0 0 0 0 0 0 0 0 0 1 0 0 1 1 0 0 0 0 1 1 0 0 0 0 0 0 0 0 0 0 0 0 0 0 0 0 0 0 0 0 0 0 0 0 0 0 0 0 0 0 0 0 0 0 0 0 0 0 0 0 0 0 0 0 0 0 0 0 0 0 0 0 0 0 0 0 
1 1 1 1 0 0 0 0 0 0 0 0 0 0 0 0 0 0 0 0 1 1 1 1 1 1 1 1 1 0 0 0 0 1 0 0 0 1 1 1 1 1 1 0 0 0 0 0 0 0 0 0 0 0 0 0 0 0 0 0 0 0 0 0 0 0 0 0 0 0 0 0 0 0 0 0 0 0 0 0 0 0 0 0 0 0 0 0 0 0 0 0 0 0 0 0 0 0 0 0