4 15 100

0 0 0 0 0 0 0 1999 2000 1949 1949 1949 1949 1949 1949 1949 1949 1949 1949 1899 1900 0 39 40 41 42 43 863 864 865 866 867 0 0 0 0 0 0 0 0 1336 1337 1388 1388 1388 1391 1338 0 0 0 0 0 0 0 0 0 0 0 0 0 0 0 0 0 0 0 0 0 0 0 0 0 0 0 0 0 0 0 0 0 0 0 0 0 0 0 0 0 0 0 0 0 0 0 0 0 0 0 0 0 
0 0 0 0 0 0 0 209 2051 1949 1949 1949 1492 1493 1949 1492 1493 1949 1949 1950 1951 1900 90 91 92 93 94 914 915 916 917 918 0 0 0 0 0 0 0 0 1387 1388 1388 1388 1388 1388 1391 1337 1338 0 0 0 0 0 0 0 0 0 0 0 0 0 0 0 0 0 0 2372 2373 2373 2373 2373 2374 0 0 0 0 0 0 0 0 0 0 0 0 0 0 0 0 0 0 0 0 2152 2350 0 0 0 0 0 
0 0 0 0 0 0 0 260 0 1999 1492 1493 1543 1544 1949 1543 1544 1949 1949 1949 1949 1951 0 0 0 0 0 0 0 0 0 0 0 0 0 0 0 0 0 0 1387 1388 1388 1388 1388 1388 1388 1388 1391 1338 0 0 0 0 0 0 0 0 0 0 0 0 0 0 2372 2373 2373 2423 0 259 259 0 2425 2373 2374 0 0 0 0 0 0 0 0 0 0 0 1761 1762 1763 0 0 0 0 887 888 0 0 0 0 0 
2158 2159 2160 2161 0 0 0 260 0 2050 1594 1544 1949 1492 1493 1949 1949 1949 1949 1949 1949 1949 1900 0 0 0 0 0 0 0 0 0 0 0 0 0 0 0 0 0 1387 1388 1388 1388 1388 1388 1388 1388 1388 1391 1338 0 0 490 491 492 0 0 0 0 0 0 0 2422 2423 2424 2527 2578 0 259 259 0 2576 2424 2425 2374 0 0 0 0 0 0 0 1761 1762 1763 1812 1813 1761 1762 1763 0 0 938 939 0 0 0 0 0 
2209 2210 2211 2212 0 0 0 260 0 0 1999 2000 1949 1543 1544 1949 1593 1999 2000 1949 1949 1950 1951 0 0 0 0 0 0 0 0 0 0 0 0 0 0 0 0 0 1387 1388 1388 0 0 0 0 1387 1388 1388 1747 0 0 0 0 0 0 0 0 0 0 0 2372 2423 2424 2527 2578 0 0 259 259 0 0 2524 2424 2425 2374 0 0 0 0 0 0 1812 1813 1814 1863 1864 1812 1813 1814 0 0 989 990 0 0 0 0 0 
0 0 0 0 0 0 0 0 0 0 2050 1949 1949 1949 2001 2002 0 2050 2051 1999 1949 1949 1949 0 0 0 0 0 0 0 0 0 0 0 0 0 0 0 0 0 1387 1388 1389 0 0 0 0 1438 1439 1341 1391 1338 0 0 0 0 0 0 0 0 0 2422 2423 2424 2527 2578 0 0 0 259 259 0 0 0 2576 2424 2425 2373 2374 0 0 0 0 1863 1864 1865 1763 0 1863 1864 1865 0 0 1040 1041 0 0 0 0 0 
0 0 0 0 0 0 0 0 0 0 0 1949 2001 2002 2052 2053 0 0 0 2050 2051 1949 1949 0 0 0 0 0 0 0 0 0 0 0 0 0 0 0 0 0 1387 1388 1747 0 0 0 0 0 0 1387 1388 1391 1338 0 0 0 0 0 0 0 0 2473 2424 2424 2477 0 0 256 257 257 257 257 258 0 0 2576 2525 2424 2425 2374 0 0 0 0 1812 1813 1814 0 0 0 0 0 0 1091 1092 0 0 0 0 0 
0 0 0 0 0 0 0 0 0 1897 1898 1949 1949 2053 0 0 0 0 0 0 0 1949 1949 0 0 0 0 0 0 0 0 0 0 0 0 0 0 0 0 1336 1342 1695 1389 0 0 0 0 0 0 1438 1439 1341 1391 1338 0 0 0 0 0 0 2422 2423 2424 2527 2578 0 0 0 0 0 0 0 0 0 0 0 2473 2424 2424 2477 0 0 0 0 1863 1864 1815 0 0 0 0 0 0 1142 1143 0 0 0 0 0 
0 0 0 0 0 0 0 0 0 1948 1949 1949 1949 1900 0 0 0 0 0 1897 1898 1950 1949 1899 1900 0 0 0 0 0 0 0 0 0 0 0 0 0 0 1387 1745 1746 1747 0 0 0 0 0 0 0 0 1387 1388 1391 1338 0 0 0 0 0 2473 2424 2424 2477 0 0 0 0 0 0 0 0 0 0 0 0 2473 2424 2424 2477 0 0 0 0 0 0 1866 0 0 0 0 0 0 1193 1194 0 0 0 2156 2157 
0 0 0 0 0 0 0 0 0 0 1949 1949 1950 1949 1899 1900 0 0 1897 1949 1949 1949 1949 1950 1951 0 0 0 0 0 0 0 0 0 0 0 0 0 1336 1342 1388 1388 1389 0 0 0 0 0 0 0 0 1438 1439 1341 1391 1338 0 0 0 0 2473 2424 2424 2477 0 0 0 0 0 0 0 0 0 0 0 0 2473 2424 2424 2425 2374 0 0 0 0 0 1815 0 0 0 0 0 0 1244 1245 0 1953 0 2207 2208 
0 0 0 0 2160 2161 0 0 1897 1898 1492 2051 2052 1493 1949 1949 1898 1899 1949 1949 1949 1949 1949 1949 1949 1899 1900 0 0 0 0 0 0 0 0 0 0 1336 1342 1388 1392 1439 1440 0 0 0 0 0 0 0 0 0 0 1387 1388 1391 1338 0 0 0 2473 2424 2424 2477 0 0 0 0 0 0 0 0 0 0 0 2372 2423 2424 2424 2424 2425 2374 0 0 0 0 1866 0 0 0 0 0 0 0 0 0 0 0 0 0 
0 0 0 0 2211 2212 0 0 1948 1949 1543 1898 1899 1544 1949 1949 1949 1949 1949 1949 1949 1949 1949 1949 1949 1950 1951 0 0 0 0 0 0 0 0 0 1336 1342 1388 1388 1389 0 0 0 1062 1063 1064 1065 1066 1067 1068 0 0 1438 1439 1341 1389 986 0 0 2473 2424 2424 2477 0 986 0 399 400 401 402 403 0 0 0 2473 0 0 2424 2424 2424 1184 0 0 0 0 1815 0 0 0 0 0 1953 0 0 0 0 0 0 0 
0 0 0 0 0 0 0 0 1184 0 0 0 0 0 0 0 0 0 0 0 0 0 0 1949 1949 1595 1593 0 0 0 0 0 0 0 0 1336 1342 1388 1340 1439 1440 0 0 0 1113 1114 1115 1116 1117 1118 1119 0 0 0 0 1387 1656 257 0 0 2473 2424 2424 2477 0 257 0 450 451 452 453 454 0 0 2372 2423 0 2424 2475 2424 2424 0 1152 0 2069 1953 1866 1953 1953 0 0 2204 0 0 0 0 0 0 0 0 
0 0 0 0 0 0 0 1184 1184 0 0 0 0 0 0 0 0 0 0 0 0 0 0 0 0 0 0 0 0 0 0 0 0 0 0 1387 1388 1340 1440 0 0 0 0 0 0 0 0 0 0 0 0 0 0 0 0 1387 1391 1338 0 2422 2423 2424 2475 2425 2374 0 0 501 502 503 504 505 0 0 0 0 0 2424 2424 2424 2424 0 1152 0 0 0 0 0 0 0 0 0 0 0 0 0 0 0 0 0 
0 0 0 0 1641 0 1184 1184 0 0 0 0 0 0 0 0 0 0 0 0 0 0 0 0 0 0 0 0 1807 0 0 0 1802 1807 0 1387 1388 1389 0 0 0 0 0 0 0 0 0 0 0 0 0 0 0 0 0 1387 1388 1391 1337 2473 2474 2474 2474 2474 2477 0 551 552 553 554 555 556 557 0 0 2526 2526 2526 2526 2526 2526 0 1152 2518 0 0 0 0 0 0 0 0 0 0 0 0 0 0 0 0

0 0 0 0 0 0 0 0 0 0 0 0 0 0 0 0 0 0 0 0 0 0 0 0 0 0 0 0 0 0 0 0 0 0 0 0 0 0 0 0 0 0 0 0 0 0 0 0 0 0 0 0 0 0 0 0 0 0 0 0 0 0 0 0 0 0 0 0 0 0 0 0 0 0 0 0 0 0 0 0 0 0 0 0 0 0 0 0 0 0 0 0 359 360 360 309 0 0 0 0 
0 0 0 0 0 0 0 0 0 0 0 0 0 0 0 0 0 0 0 0 0 0 0 162 163 164 165 166 162 163 164 165 166 162 163 162 163 164 165 166 0 0 0 0 0 0 0 0 0 0 0 0 0 0 0 0 0 0 0 0 0 0 0 0 0 0 0 0 0 0 0 0 0 0 0 0 0 0 0 0 0 0 0 0 0 0 0 1761 1762 1763 0 0 256 257 257 258 0 0 0 0 
0 0 0 0 0 0 0 0 0 0 0 0 0 0 0 0 0 0 0 0 0 0 0 1244 1152 1152 1152 1152 1152 1152 1152 1152 1152 1152 1152 1152 1152 1152 1152 1245 0 0 0 0 0 0 0 0 0 0 0 0 0 0 0 0 0 0 0 0 0 0 0 0 0 0 0 0 2577 2577 2577 2577 0 0 0 0 0 0 0 0 0 0 0 0 0 0 0 1812 1813 1814 0 0 0 0 0 0 0 0 0 0 
0 0 0 0 0 0 0 0 0 0 0 0 0 0 0 0 0 0 0 0 0 0 0 0 1244 1150 1150 1150 1150 1150 1150 1150 1150 1150 1150 1150 1150 1150 1245 0 0 0 0 0 0 0 0 0 0 0 0 0 0 0 0 0 0 0 0 0 0 0 0 0 0 0 0 0 0 0 0 0 0 0 0 0 0 0 0 0 0 0 0 0 0 0 0 1863 1864 1865 0 0 0 0 0 0 0 0 0 0 
1394 1394 1394 1394 1394 1394 1394 1394 1396 0 0 0 0 0 0 0 0 0 0 0 0 0 0 0 0 0 0 0 0 0 0 0 0 0 0 0 0 0 0 0 0 0 1802 1803 1804 1805 1806 1807 0 0 0 1802 1803 1804 1805 1806 1807 0 0 0 0 0 0 0 0 0 0 0 0 0 0 0 0 0 0 0 0 0 0 0 0 0 0 0 0 0 0 0 0 0 0 0 0 0 0 0 0 0 0 0 
1152 1152 1152 1152 1152 1152 1458 1355 0 0 0 0 0 0 0 0 0 0 0 0 0 0 0 0 0 0 0 0 0 0 0 0 0 0 0 0 0 0 0 0 0 0 1853 1854 1855 1856 1857 1858 0 0 0 1853 1854 1855 1856 1857 1858 0 0 0 0 0 0 0 0 0 0 985 986 0 0 985 986 0 0 0 0 0 0 0 0 0 0 0 0 0 0 1761 1762 1763 0 0 0 0 0 0 0 0 0 0 
1152 941 1152 1152 1152 1458 1509 0 0 0 0 0 0 0 0 0 0 0 0 0 0 0 0 0 0 0 0 0 0 0 0 0 0 0 0 0 0 0 0 0 0 0 0 0 0 0 0 0 0 0 0 0 0 0 0 0 0 0 0 0 0 0 0 0 0 0 0 1622 1623 1729 1729 1622 1623 0 0 0 0 0 0 0 0 0 0 0 0 0 0 1812 1813 1814 0 0 0 0 0 0 0 0 0 0 
991 1196 1152 1152 1458 1509 0 0 0 0 0 0 0 0 0 0 0 0 0 0 0 0 0 0 0 0 0 0 0 0 0 0 0 0 0 0 0 0 0 0 0 0 0 0 0 0 0 0 0 0 0 0 0 0 0 0 0 0 0 0 0 0 0 0 0 0 0 1673 1674 1780 1780 1673 1674 0 0 0 0 0 0 0 0 0 0 0 0 0 1864 1863 1864 1865 0 0 0 0 0 0 0 0 0 0 
1152 1152 1152 1458 1509 0 0 0 0 0 0 0 0 0 0 0 0 0 0 0 0 0 0 0 0 0 0 0 0 0 0 0 0 0 0 0 0 0 0 0 0 0 0 0 0 0 0 0 0 0 0 0 0 0 0 0 0 0 0 0 0 0 0 0 0 0 0 1724 1725 0 0 1724 1725 0 0 0 0 0 0 0 0 0 0 0 0 0 0 0 0 0 0 0 0 0 0 0 2310 2311 2312 0 
1354 1354 1406 1407 0 0 0 0 0 0 0 0 0 0 0 0 0 0 0 0 0 0 0 0 0 0 0 0 0 0 0 0 0 0 0 0 0 0 0 0 0 0 0 0 0 0 0 0 0 0 0 0 0 0 0 0 0 0 0 0 0 0 0 0 0 0 0 1775 1776 0 0 1775 1776 0 0 0 0 0 0 0 0 0 0 0 0 0 0 0 0 0 0 0 2203 2204 2205 1954 2361 2362 2363 1955 
0 0 0 0 0 0 0 0 0 0 0 0 0 0 0 0 0 0 0 0 0 0 0 0 0 0 0 0 0 0 0 0 0 0 0 0 0 0 0 0 0 0 0 0 0 0 0 0 0 0 0 0 0 0 0 0 0 0 0 0 0 0 0 0 0 0 0 0 0 0 0 0 0 0 0 0 0 0 0 0 2203 2204 2206 0 0 0 0 2120 2121 0 0 0 2254 2255 2255 2004 2004 2004 2004 2004 
0 0 0 0 0 1596 1597 1598 0 0 1596 1597 1598 0 0 0 0 0 0 0 0 0 0 0 0 0 0 0 0 0 0 0 0 0 0 0 0 0 0 0 0 0 22 23 24 25 26 0 0 0 0 0 0 0 0 0 0 360 0 0 0 0 0 0 0 360 0 0 0 0 0 0 0 0 0 0 1152 1152 0 0 2254 2255 2257 2206 2310 2311 2312 2171 2172 0 0 2203 2254 1152 1152 1152 1152 1152 1152 1152 
0 0 0 0 1072 1073 1073 1073 1073 1073 1074 1075 1891 1888 1889 1889 1889 1889 1889 1889 1889 1889 1890 0 0 0 0 0 1907 0 0 0 1911 1912 0 0 0 0 0 0 0 0 73 74 75 76 77 0 0 0 165 165 0 0 0 0 0 261 0 0 0 0 0 0 0 261 0 0 0 0 0 0 0 0 0 0 1152 260 0 0 938 1152 1152 2257 2361 2362 2363 2222 2223 2204 2204 2254 2255 1152 1152 1152 1152 1152 1152 1152 
0 0 0 0 1174 1229 1124 1124 1124 1124 1125 1126 1942 1939 1940 1940 1940 1940 1940 1940 1940 1940 1941 1483 1483 1279 0 1957 1958 1959 1960 1961 1962 1963 0 0 0 0 0 0 1152 1152 1152 1152 1152 1152 1152 1152 1152 1152 1152 1152 0 0 0 0 0 312 0 0 0 0 0 0 0 261 0 0 0 0 0 0 0 0 1152 1152 1152 260 0 0 938 1152 1152 2004 1152 2004 2004 2004 2004 2004 2004 2255 1152 1152 1152 1152 1152 1152 1152 1152 
0 0 0 0 0 1123 1124 1124 1124 1124 1125 1177 1993 1939 1940 1940 1940 1940 1940 1940 1940 1940 1941 1534 1534 1330 1805 1806 2009 2010 2011 2012 2013 2014 0 0 0 0 1152 1152 1152 0 0 0 0 0 0 0 0 0 0 0 1152 1152 1152 0 0 261 0 0 0 0 0 0 0 312 0 0 0 0 0 0 0 1152 1152 259 259 260 0 0 938 1152 1152 1152 1152 1152 1152 1152 1152 1152 1152 1152 1152 1152 1152 1152 1152 1152 1152 1152

85 86 87 88 89 0 0 0 0 0 0 0 0 0 0 0 0 0 0 0 0 0 0 0 0 0 0 0 0 0 0 0 0 0 39 40 41 42 43 44 0 0 0 0 0 0 0 0 0 0 0 0 0 0 0 0 0 0 0 0 0 0 0 0 0 0 0 0 0 0 0 0 0 0 0 0 0 0 0 0 0 0 0 0 0 0 0 0 0 0 0 0 0 0 0 0 0 0 0 0 
136 137 138 139 140 0 0 360 0 0 0 0 0 0 0 0 0 0 0 0 0 0 0 687 688 690 235 236 237 238 239 235 236 237 238 91 92 93 94 95 0 0 0 0 0 0 0 0 0 0 0 0 0 0 0 0 0 0 0 0 0 0 0 0 0 0 0 0 0 0 0 0 0 0 0 0 0 0 0 0 0 0 0 0 1761 1762 1763 0 0 0 0 0 1818 1819 1820 1821 0 0 0 0 
187 188 189 190 191 0 0 1628 0 0 0 0 0 0 0 0 0 0 0 0 0 0 0 472 473 474 472 473 474 472 473 474 472 473 474 474 473 472 473 474 0 0 0 0 0 0 0 1907 0 0 0 1911 1912 0 0 0 0 0 0 0 0 0 0 0 0 0 0 0 0 0 0 0 0 0 0 0 0 0 0 0 0 0 0 0 1812 1813 1814 0 0 0 0 0 1869 1870 1871 1872 0 0 0 0 
0 0 240 241 242 0 0 1679 0 0 0 0 0 0 0 0 0 0 0 0 0 0 0 0 0 1826 1827 0 0 1622 1623 0 0 0 0 0 1618 1619 0 0 0 0 0 48 49 50 1957 1958 1959 1960 1961 1962 1963 0 0 0 0 0 0 0 0 0 0 0 0 0 0 0 0 0 0 0 0 0 0 0 0 0 0 0 0 0 0 0 1863 1864 1865 0 0 0 0 0 1920 1921 1922 1923 0 0 0 0 
0 0 291 0 2107 2108 0 0 0 0 0 0 0 0 0 0 0 0 0 0 0 0 0 0 0 1877 1878 0 0 1673 1674 0 0 0 0 0 1669 1670 0 0 0 0 1444 1445 1445 1445 1445 2009 2010 2011 2012 2013 1445 1445 1445 1445 1447 0 0 0 0 0 0 0 0 0 0 0 0 0 0 0 0 0 0 0 0 0 0 0 0 0 0 0 0 1761 1762 1763 0 0 0 0 1971 1972 1973 1974 0 0 0 0 
1445 1445 1445 1445 1445 1445 1445 1446 1447 0 0 0 0 0 40 41 42 0 0 0 0 0 0 0 0 1928 1929 0 0 1724 1725 0 0 0 0 0 1720 1721 0 0 0 0 0 0 0 0 0 0 0 0 0 0 0 0 0 0 0 0 0 0 0 0 0 0 0 0 0 360 360 360 360 360 360 0 0 0 0 0 0 0 0 0 1761 1762 1763 1812 1813 1814 0 0 0 0 2022 2023 2024 2025 0 0 0 0 
0 0 0 0 0 0 0 0 0 0 0 0 0 0 91 92 93 94 95 0 0 0 0 0 0 1979 1980 0 0 1775 1776 0 0 0 0 0 1771 1772 0 0 0 0 0 0 0 0 0 0 0 0 0 752 0 0 0 0 0 0 0 0 0 0 0 0 0 0 0 0 0 1631 1631 0 0 0 0 0 0 0 0 0 0 0 1812 1813 1814 1863 1864 1865 0 0 0 0 2073 2074 2075 2076 0 0 0 0 
0 0 0 0 0 0 0 0 0 0 0 0 0 141 142 143 144 145 146 0 0 0 0 0 0 0 0 0 0 0 0 0 0 0 0 0 0 0 0 0 0 0 0 0 0 0 0 0 0 0 802 803 804 805 0 0 0 0 0 0 0 0 0 0 0 0 0 0 0 1682 1682 0 0 0 0 0 0 0 0 0 0 0 1863 1864 1865 0 0 0 0 0 0 0 2124 2125 2126 2127 0 0 0 0 
0 0 0 0 0 0 0 0 0 0 0 0 0 192 193 194 195 196 197 0 0 468 469 470 0 0 0 0 0 0 0 0 0 0 0 0 0 0 0 0 0 0 0 0 0 0 0 0 0 852 853 854 855 856 857 0 0 0 0 0 0 0 0 0 0 0 0 0 0 0 0 0 0 0 0 0 0 0 0 0 0 0 0 0 0 0 0 0 0 0 0 0 2175 2176 2177 2178 0 0 0 0 
0 0 0 0 0 0 0 0 0 0 0 0 0 243 244 245 246 247 0 0 0 519 520 521 0 0 0 0 0 0 0 0 0 0 0 0 0 0 0 0 0 0 0 0 0 0 0 0 902 903 0 905 906 0 0 0 0 0 0 0 0 0 0 0 0 0 0 0 0 0 0 0 0 0 0 0 0 0 0 0 2160 2161 0 2265 0 0 0 0 0 0 0 0 0 0 1063 1064 1065 1066 1067 1068 
0 0 0 0 0 0 0 0 0 0 0 0 0 0 0 296 0 0 0 0 0 570 571 572 0 0 0 0 0 0 0 0 0 0 0 0 0 0 0 0 0 0 0 0 0 0 0 0 953 954 955 956 957 0 0 0 0 736 737 738 739 740 741 742 743 744 0 0 0 0 0 0 0 0 0 0 0 0 0 0 2211 2212 0 2316 0 0 0 0 0 0 0 0 0 1113 1114 1115 1116 1117 1118 1119 
0 0 0 0 409 410 411 412 0 0 0 0 1596 1597 1598 347 637 638 636 637 638 621 622 0 0 0 0 0 0 0 0 0 0 0 0 0 0 0 0 0 2164 0 0 0 0 0 0 0 1004 1005 1006 1007 0 0 0 0 0 787 788 789 790 791 792 793 794 795 0 0 0 0 0 0 0 0 0 0 538 540 0 0 0 0 0 2367 0 0 2271 2272 2268 2269 0 0 1163 1164 1165 1166 1167 1168 1169 1170 
0 0 0 0 0 0 0 0 0 0 0 0 0 0 0 0 0 0 0 0 0 0 0 636 637 639 0 0 0 0 0 0 0 0 0 0 0 0 0 0 2215 163 163 163 163 163 163 163 163 163 1057 1058 0 0 0 0 0 838 839 840 841 842 843 844 845 846 0 0 0 0 0 0 0 0 0 0 591 1628 0 0 0 0 1200 0 0 0 2322 2323 2319 2320 0 0 1214 1215 1216 1217 1218 1219 1220 1221 
0 0 0 0 0 0 0 0 0 0 0 0 0 0 0 0 0 0 0 0 0 0 0 0 0 0 0 0 0 0 0 0 0 0 0 0 0 0 2216 163 984 981 1137 1083 982 983 1136 983 1087 1137 1085 984 163 163 163 0 0 160 0 0 0 0 0 0 0 160 0 0 16 17 0 0 0 0 640 641 642 1679 0 0 0 0 0 2467 2468 2469 0 0 0 0 0 0 1265 1266 1267 1268 1269 1270 1271 1272 
0 0 0 0 0 0 0 0 0 0 0 0 0 0 0 0 0 0 0 0 0 0 0 0 0 0 2358 2359 2360 0 0 0 0 2262 0 0 0 0 1086 983 1088 981 1082 983 983 983 984 984 1136 1137 1083 1087 1137 981 1089 0 0 211 0 0 0 0 0 0 0 211 0 0 67 68 0 0 0 691 693 0 0 0 0 0 0 0 2467 2518 2519 2520 2469 0 0 0 0 0 1316 1317 1318 1319 1320 1321 1322 1323

0 0 0 0 0 0 0 0 0 0 0 0 0 0 0 0 0 0 0 0 0 0 0 0 0 0 0 0 0 0 0 0 0 0 0 0 0 0 0 0 0 0 0 0 0 0 0 0 0 0 0 0 0 0 0 0 0 0 0 0 0 0 0 0 0 0 0 0 0 0 0 0 0 0 0 0 0 0 0 0 0 0 0 0 0 0 0 0 0 0 0 0 0 0 0 0 0 0 0 0 
0 0 0 0 0 0 0 0 0 0 0 0 0 0 0 0 0 0 0 0 0 0 0 0 0 0 0 0 0 0 0 0 0 0 0 0 0 0 0 0 0 0 0 0 0 0 0 0 0 0 0 0 0 0 0 0 0 0 0 0 0 0 0 0 0 0 0 0 0 0 0 0 0 0 0 0 0 0 0 0 0 0 0 0 0 0 0 0 0 0 0 0 0 0 0 0 0 0 0 0 
0 0 0 0 0 0 0 0 0 0 0 0 0 0 0 0 0 0 0 0 0 0 0 1 1 1 1 1 1 1 1 1 1 1 1 1 1 1 1 1 0 0 0 0 0 0 0 0 0 0 0 0 0 0 0 0 0 0 0 0 0 0 0 0 0 0 0 0 0 0 0 0 0 0 0 0 0 0 0 0 0 0 0 0 0 0 0 0 0 0 0 0 0 0 0 0 0 0 0 0 
0 0 0 0 0 0 0 0 0 0 0 0 0 0 0 0 0 0 0 0 0 0 0 0 1 1 1 1 1 1 1 1 1 1 1 1 1 1 1 0 0 0 0 0 0 0 0 0 0 0 0 0 0 0 0 0 0 0 0 0 0 0 0 0 0 0 0 0 0 0 0 0 0 0 0 0 0 0 0 0 0 0 0 0 0 0 0 0 0 0 0 0 0 0 0 0 0 0 0 0 
0 0 0 0 0 0 0 0 0 0 0 0 0 0 0 0 0 0 0 0 0 0 0 0 0 0 0 0 0 0 0 0 0 0 0 0 0 0 0 0 0 0 1 1 1 1 1 1 1 1 1 1 1 1 1 1 1 0 0 0 0 0 0 0 0 0 0 0 0 0 0 0 0 0 0 0 0 0 0 0 0 0 0 0 0 0 0 0 0 0 0 0 0 0 0 0 0 0 2 0 
1 1 1 1 1 1 1 1 0 0 0 0 0 0 0 0 0 0 0 0 0 0 0 0 0 0 0 0 0 0 0 0 0 0 0 0 0 0 0 0 0 0 0 0 0 0 0 0 0 0 0 0 0 0 0 0 0 0 0 0 0 0 0 0 0 0 0 0 0 0 0 0 0 0 0 0 0 0 0 0 0 0 0 0 0 0 0 0 0 0 0 0 0 0 0 0 0 0 0 0 
0 0 0 0 0 1 1 0 0 0 0 0 0 0 0 0 0 0 0 0 0 0 0 0 0 0 0 0 0 0 0 0 0 0 0 0 0 0 0 0 0 0 0 0 0 0 0 0 0 0 0 0 0 0 0 0 0 0 0 0 0 0 0 0 0 0 0 0 0 0 0 0 0 0 0 0 0 0 0 0 0 0 0 0 0 0 0 0 0 0 0 0 0 0 0 0 0 0 0 0 
0 0 0 1 1 1 0 0 2 0 0 0 0 0 0 0 0 0 0 2 0 0 0 0 0 0 0 0 0 0 0 0 0 0 0 0 0 0 0 0 0 0 0 0 0 0 0 0 0 0 0 0 0 0 0 0 0 0 0 0 0 0 0 0 0 0 0 0 0 0 0 0 0 0 0 0 0 0 0 0 0 0 0 0 0 0 0 0 0 0 0 0 0 0 0 0 0 0 0 0 
0 0 0 1 1 0 0 0 0 0 0 0 0 0 0 0 0 0 0 0 0 0 0 0 0 0 0 0 0 0 0 0 0 0 0 0 0 0 0 0 0 0 0 0 0 2 0 0 0 0 0 0 0 0 0 0 0 0 0 0 0 0 0 0 0 0 0 0 0 0 0 0 0 0 0 0 0 0 0 0 0 0 0 0 0 0 0 2 0 0 0 0 0 0 0 0 0 0 0 0 
1 1 1 1 0 0 0 0 0 0 0 0 0 0 0 0 0 0 0 0 0 0 0 0 0 0 0 0 0 0 0 0 0 0 0 0 0 0 0 0 0 0 0 0 0 0 0 0 0 0 0 0 0 0 0 0 0 0 0 0 0 0 0 0 0 0 0 0 0 0 0 0 0 0 0 0 0 0 0 0 0 0 0 0 0 0 0 0 0 0 0 0 0 0 0 0 0 0 0 0 
0 0 0 0 0 0 0 0 0 0 0 0 0 0 0 0 0 0 0 0 0 0 0 0 0 0 0 0 0 0 0 0 0 0 0 0 0 0 0 0 0 0 0 0 0 0 0 0 0 0 0 0 0 0 0 0 0 0 0 0 0 0 0 0 0 0 0 0 0 0 0 0 0 0 0 0 0 0 0 0 0 0 0 0 0 0 0 0 0 0 0 0 1 1 1 1 1 1 1 1 
0 0 0 0 0 0 0 0 0 0 0 0 0 0 0 0 0 0 0 0 0 0 0 0 0 0 0 0 0 0 0 0 0 0 0 0 0 0 0 0 0 0 0 0 0 0 0 0 0 0 0 0 0 0 0 0 0 0 0 0 0 0 0 0 0 0 0 0 0 0 0 0 0 0 0 0 1 1 0 0 1 1 1 0 0 0 0 0 0 0 0 0 1 0 0 0 0 0 0 1 
0 0 0 0 1 1 1 1 1 1 1 1 1 1 1 1 1 1 1 1 1 1 1 0 0 0 0 0 0 0 0 0 0 0 0 0 0 0 0 0 0 0 0 0 0 0 0 0 0 0 0 0 0 0 0 0 0 1 1 1 1 1 1 1 1 1 0 0 0 0 0 0 0 0 0 0 1 0 0 0 1 0 1 1 0 0 0 0 0 0 0 1 1 0 0 0 0 0 0 1 
0 0 0 0 1 0 0 0 0 0 0 0 0 0 0 0 0 0 0 0 0 0 1 1 1 1 0 0 0 0 0 0 0 0 0 0 0 0 0 0 1 1 1 1 1 1 1 1 1 1 1 1 0 0 0 0 0 0 0 0 0 0 0 0 0 0 0 0 1 1 0 0 0 0 1 1 1 0 0 0 1 0 0 1 1 1 1 1 1 1 1 1 0 0 0 0 0 0 0 1 
0 0 0 0 1 0 0 0 0 0 0 0 0 0 0 0 0 0 0 0 0 0 0 0 0 1 1 1 1 1 1 1 1 1 0 0 0 0 1 1 1 0 0 0 0 0 0 0 0 0 0 1 1 1 1 0 0 0 0 0 0 0 0 0 0 0 0 0 1 1 0 0 0 1 1 0 0 0 0 0 1 0 0 0 0 0 0 0 0 0 0 0 0 0 0 0 0 0 0 1
