4 15 100

0 0 0 0 0 0 0 0 0 0 0 0 0 0 0 0 0 0 0 0 0 0 0 0 0 0 0 0 0 0 0 0 0 0 0 0 0 0 0 0 0 0 0 0 0 0 0 0 0 0 0 0 0 0 0 0 0 0 0 0 0 0 2164 0 0 0 0 0 0 0 0 0 0 0 0 0 0 0 0 0 0 0 0 0 0 0 0 0 0 0 0 0 0 0 0 0 0 0 0 0 
0 0 0 0 0 0 0 0 0 0 0 0 0 0 0 0 0 0 0 0 0 0 0 0 0 0 0 0 0 0 0 0 0 0 0 0 0 0 0 0 0 0 0 0 0 0 0 0 0 0 0 0 0 0 0 0 0 0 0 0 0 0 2215 0 0 0 0 0 0 0 0 0 0 0 0 0 0 0 0 0 0 0 0 0 0 0 0 0 0 0 0 0 0 0 0 0 0 0 0 0 
0 0 0 0 0 0 0 0 0 0 0 0 0 0 0 0 0 0 0 0 0 0 0 0 0 0 0 0 0 0 0 0 0 0 0 0 0 0 0 0 0 0 0 0 0 0 0 0 0 0 0 0 0 0 0 0 0 0 0 0 0 0 0 0 0 0 0 0 0 0 0 0 0 0 0 0 0 0 0 0 0 0 0 0 0 0 0 0 0 0 0 0 0 0 0 0 0 0 0 0 
0 0 0 0 0 0 0 0 0 0 0 0 0 0 0 0 0 0 0 0 0 0 0 0 0 0 0 0 0 0 0 0 0 0 0 0 0 0 0 0 0 0 0 0 0 0 0 0 0 0 0 0 0 0 0 0 0 0 0 0 0 0 0 0 0 0 0 0 0 0 0 0 0 0 0 0 0 0 0 0 0 0 0 0 0 0 0 0 0 0 0 1105 1106 1107 1108 1109 0 0 0 0 
0 0 0 0 0 0 0 0 0 0 0 0 0 0 0 0 0 0 0 0 0 0 0 0 0 0 0 0 0 0 0 0 0 0 0 0 0 2158 2159 0 0 0 0 0 0 0 0 0 0 0 0 0 0 0 0 0 0 0 0 0 0 0 0 0 0 0 0 0 0 0 0 0 0 0 0 0 0 0 0 0 0 0 0 0 0 0 0 0 0 0 1155 1156 1157 1158 1159 1160 0 0 0 0 
0 0 0 0 0 0 0 0 0 0 0 0 0 0 0 0 0 0 0 0 0 0 0 0 0 0 0 0 0 0 0 0 0 0 0 0 0 2209 2210 687 1596 1597 1598 687 688 689 690 690 689 690 0 0 0 0 0 0 0 0 0 0 0 0 0 0 0 0 0 0 0 0 0 0 0 0 0 0 0 0 0 0 0 0 0 0 0 0 0 0 0 0 0 0 0 0 0 0 0 0 0 0 
0 0 0 0 0 0 0 0 0 0 0 0 0 0 0 0 0 0 0 0 0 0 0 0 0 0 0 0 0 0 0 0 0 0 0 688 687 0 0 0 0 0 0 0 0 0 0 0 0 0 0 0 0 0 0 0 0 0 0 0 0 0 0 0 0 0 0 0 0 0 0 0 0 0 0 0 0 0 0 0 0 0 0 0 0 0 0 0 0 0 0 0 0 0 0 0 0 0 0 0 
0 0 0 0 0 0 0 0 0 0 0 0 0 0 0 0 0 0 0 0 0 0 0 0 0 0 0 0 0 323 324 325 0 690 687 166 0 0 0 0 0 0 0 0 0 0 0 0 0 0 0 313 0 0 0 0 0 0 0 0 313 0 0 0 0 0 0 0 0 0 0 0 0 0 0 0 0 0 0 0 0 0 383 384 385 386 0 0 0 0 0 0 0 0 0 0 0 0 0 0 
0 0 0 0 0 0 0 0 0 0 0 0 0 0 0 0 0 0 0 0 0 0 0 0 0 0 0 0 0 374 375 376 0 0 0 0 0 0 0 0 0 0 313 0 0 0 0 0 0 0 0 313 0 0 0 0 0 0 0 0 313 0 0 0 0 0 0 0 0 0 0 0 0 0 0 0 0 0 0 0 0 0 434 435 436 437 0 0 0 0 0 0 0 0 0 0 0 0 0 0 
0 0 0 0 0 0 0 0 0 0 0 0 0 0 0 0 0 0 0 0 0 0 0 0 0 329 0 0 0 425 426 427 18 0 0 0 0 0 0 0 0 0 313 0 0 0 0 0 0 0 690 313 687 688 687 689 689 688 689 690 313 175 176 177 178 179 180 0 0 0 0 0 0 0 0 0 0 0 0 219 216 0 0 0 0 0 0 0 0 0 0 0 0 0 0 0 0 0 0 0 
0 0 52 53 54 55 56 57 0 0 0 0 0 0 0 0 0 0 0 0 0 0 0 0 0 380 381 0 0 476 477 690 69 0 0 0 0 0 0 0 0 0 313 0 0 0 0 0 0 0 0 0 0 0 0 0 0 0 0 0 0 0 0 0 0 0 0 0 0 0 0 0 0 0 0 0 0 0 0 0 0 0 0 0 0 0 0 0 0 0 0 0 0 0 0 0 0 0 0 0 
0 0 103 104 105 106 107 108 411 412 0 0 0 0 0 0 0 0 0 0 0 58 59 60 430 431 432 0 0 0 0 0 0 0 0 0 0 0 0 0 0 0 313 0 0 0 0 0 0 0 0 0 0 0 0 0 0 0 0 0 0 0 0 0 0 0 0 0 0 23 24 25 0 0 0 0 0 0 155 0 0 371 0 0 0 0 0 0 0 0 0 0 0 0 0 0 0 0 0 0 
0 0 0 0 0 0 0 0 0 0 0 0 0 0 0 0 169 169 120 121 122 109 110 111 481 482 483 0 0 0 0 0 0 0 0 0 0 0 0 0 0 0 307 360 360 360 360 0 0 0 317 264 266 268 265 267 266 269 367 268 269 266 368 368 268 0 0 0 0 0 0 0 0 0 0 1761 1762 1762 1762 0 0 0 0 0 0 0 0 0 0 0 0 0 0 0 0 0 0 0 0 0 
0 0 0 0 0 0 0 0 0 0 0 0 0 0 0 0 0 0 0 0 0 0 0 0 0 0 0 0 0 0 0 0 0 0 0 0 0 0 0 0 0 0 0 0 0 0 0 0 0 0 0 424 423 423 421 424 422 423 423 269 268 365 264 266 0 0 0 0 0 0 0 0 0 0 0 1812 1813 1813 1813 0 0 0 0 0 0 0 0 0 0 0 0 0 0 0 0 0 0 0 0 0 
0 0 0 0 0 0 0 0 0 0 0 0 0 0 0 0 0 0 0 0 0 0 0 0 0 0 0 0 0 0 0 0 0 0 0 0 0 0 0 0 0 0 0 0 0 0 0 0 0 0 0 0 267 266 264 269 267 368 266 269 264 264 364 0 0 0 0 0 0 0 0 0 0 0 0 1863 1813 1813 1813 0 0 0 0 0 0 0 0 0 0 0 0 0 0 0 0 0 0 0 0 0

0 0 0 0 0 0 0 0 0 0 0 0 0 0 0 0 0 0 0 0 0 0 0 0 0 0 0 0 0 0 0 0 0 0 0 0 0 0 0 0 0 0 0 0 0 0 0 0 0 0 0 0 0 0 0 0 0 0 0 0 0 0 0 0 0 0 0 0 0 0 0 0 0 0 0 0 0 0 0 0 0 0 0 0 0 0 0 0 0 0 0 0 0 0 0 0 0 0 0 0 
0 0 0 0 0 0 0 0 0 0 0 0 0 0 0 0 0 0 0 0 0 0 0 0 0 0 0 0 0 0 0 0 0 0 0 0 0 0 0 0 0 0 0 0 0 0 0 0 0 0 0 0 0 0 0 0 0 0 0 163 164 163 167 163 0 0 0 0 0 0 0 0 0 0 0 0 0 0 0 0 0 0 0 0 0 0 0 0 0 0 0 0 0 0 0 0 0 0 0 0 
0 0 0 0 0 0 0 0 0 0 0 0 0 0 0 0 0 0 0 0 0 0 0 0 0 0 0 0 0 0 0 0 0 0 0 0 0 0 0 0 0 31 32 33 0 0 0 0 0 0 0 0 0 0 0 0 0 0 0 366 1888 1889 1890 369 0 0 0 0 0 0 0 0 0 0 0 0 0 0 0 0 0 0 0 0 0 0 0 0 0 0 0 0 0 0 0 0 0 0 0 0 
0 0 0 0 0 0 0 0 0 0 0 0 0 0 0 0 0 0 0 0 0 0 0 0 0 0 0 0 0 0 0 0 0 0 0 0 0 0 0 0 0 82 83 84 0 0 0 0 0 0 0 0 0 0 0 0 0 0 0 417 1939 1940 1941 420 0 0 0 0 0 0 0 0 0 0 0 0 0 0 0 0 0 0 0 0 0 0 0 0 0 0 0 0 0 0 0 0 0 0 0 0 
0 0 0 0 0 0 0 0 0 0 0 0 0 0 0 0 0 0 0 0 0 0 0 0 0 0 0 0 0 0 0 0 0 0 0 0 0 0 0 0 0 133 134 135 0 0 0 0 0 0 0 0 0 0 0 0 0 0 0 0 1233 1991 1131 0 0 0 0 0 0 0 0 0 0 0 0 0 0 0 0 0 0 0 0 0 0 0 0 0 0 0 1394 1394 1395 1395 1395 1394 1394 1394 1396 1394 
0 0 0 0 0 0 0 0 0 0 0 0 0 0 0 0 0 0 0 0 0 0 0 0 0 0 0 0 0 0 0 0 0 0 0 0 0 636 639 162 164 0 185 0 164 166 167 162 162 163 0 0 0 0 0 0 0 0 0 0 0 0 0 0 0 0 0 0 0 0 0 0 0 0 0 0 0 0 0 0 0 0 0 0 0 0 1393 1394 1394 1394 1152 1152 1152 1152 1152 1152 991 1152 1095 1095 
0 0 0 0 0 0 0 0 0 0 0 0 0 0 0 0 0 0 0 0 0 0 0 0 0 0 0 0 0 0 0 0 0 0 0 167 162 1072 1074 218 218 214 216 218 217 218 218 217 215 222 0 0 0 0 0 0 0 0 0 0 0 0 0 0 0 0 0 0 0 0 0 0 0 0 0 0 0 0 0 0 0 0 0 0 0 0 0 887 1145 1152 1152 1145 1152 1152 1146 1152 1152 1152 1196 1095 
0 0 0 0 0 0 0 0 0 0 0 0 0 0 0 0 0 0 0 0 0 0 0 0 0 0 0 0 0 0 0 0 0 165 166 219 214 1123 1080 539 539 0 0 0 0 0 0 0 272 273 0 257 257 257 257 257 257 257 257 257 257 0 0 0 0 0 0 0 0 0 0 0 0 0 0 0 0 0 0 0 0 0 0 0 0 0 0 938 1152 1146 1152 1152 1152 1152 1152 1152 1146 941 1095 1095 
0 0 0 0 0 0 0 0 0 0 0 0 0 0 0 0 0 0 0 0 0 0 0 0 0 0 0 0 0 0 0 0 0 219 220 539 539 1123 1080 368 538 368 369 370 368 418 417 271 272 0 0 0 0 0 0 0 0 0 0 0 0 0 0 0 0 0 0 0 0 0 0 0 0 0 0 0 0 0 0 162 163 164 165 166 162 164 0 1251 1152 1152 1152 1152 1145 1152 1095 1095 1095 1095 1095 992 
0 0 0 0 0 0 0 0 0 0 0 0 0 0 0 0 0 0 0 0 0 0 0 0 0 0 0 0 0 0 0 0 0 270 271 364 539 1123 1080 367 0 419 420 0 419 166 166 688 689 688 167 162 162 166 166 162 164 164 163 165 164 162 165 162 164 162 164 0 0 0 0 0 0 0 0 0 0 0 1642 1643 1644 1803 217 218 368 369 0 1302 1253 1152 1197 1152 1152 1095 1095 1197 1095 1095 1095 1095 
0 0 0 0 0 0 0 0 0 0 0 0 0 0 0 0 0 0 0 0 0 0 0 0 0 0 0 0 0 167 164 163 167 0 0 415 365 1123 1080 418 0 307 0 0 0 219 220 1480 1481 1482 216 214 213 218 216 218 214 214 214 215 216 216 214 214 214 216 222 0 0 0 0 0 0 0 0 0 0 0 1693 1694 1695 217 371 368 369 420 0 0 1304 1253 1152 941 1152 1095 1095 1095 1095 1146 1095 1095 
163 166 165 166 164 167 166 164 163 162 0 0 0 0 0 0 0 0 0 0 0 0 0 0 0 0 0 0 0 219 220 221 222 0 0 0 417 1123 1080 360 307 309 0 0 0 270 220 1531 1532 1533 264 221 221 266 220 221 266 265 220 221 267 264 268 267 221 222 273 0 0 167 164 164 0 0 0 0 0 0 1744 1745 1746 0 368 369 420 0 0 0 0 1304 1253 1152 1152 1356 941 1095 940 1095 1095 1347 
218 218 216 217 216 216 217 216 218 369 0 0 0 0 0 0 162 165 164 167 162 166 165 162 165 163 163 0 0 270 271 272 273 0 0 0 0 1233 1131 0 359 0 0 0 0 0 271 1531 1532 1533 1486 221 0 0 0 0 0 0 0 0 0 0 0 0 272 273 0 0 0 219 221 222 0 0 307 257 257 257 1744 1745 1746 0 419 420 0 0 0 0 0 0 1200 1201 1354 1457 1458 1354 1457 1095 1095 1095 
370 371 372 373 362 363 365 366 367 420 0 0 0 0 0 0 219 215 218 217 218 218 216 217 218 218 222 0 0 0 0 0 0 0 0 0 0 0 0 0 0 0 0 0 0 0 0 1531 1532 1637 1537 1486 0 221 0 220 221 0 0 0 0 0 221 222 273 0 0 0 0 270 272 273 0 0 0 0 0 0 1744 1796 1197 0 0 0 0 0 0 0 0 0 0 0 0 1508 1509 0 1508 1457 1197 1095 
421 422 423 424 413 414 416 419 0 0 0 0 0 0 0 0 270 264 265 264 264 265 266 267 268 272 0 0 0 0 0 0 0 0 0 0 0 0 0 0 0 0 0 0 0 0 0 1531 1532 1328 1328 1537 1486 0 0 0 0 0 0 0 0 0 272 273 0 0 0 0 0 0 0 0 0 0 0 0 0 0 1795 1796 1797 0 0 0 0 0 0 0 0 0 0 0 0 0 0 0 0 1455 1095 1095

0 0 0 0 0 0 0 0 0 0 0 0 0 0 0 0 0 0 0 0 0 0 0 0 0 0 0 0 0 0 0 0 0 0 0 0 35 36 37 38 0 0 0 0 551 552 553 554 555 556 557 0 0 0 0 0 0 0 0 0 567 568 569 0 0 0 0 0 0 0 0 0 0 0 0 0 0 1204 1205 1206 1207 1208 1209 1210 1211 1212 0 0 0 0 0 0 0 0 0 0 0 0 0 0 
0 0 0 0 0 0 0 0 0 0 0 0 0 0 0 0 0 0 0 0 0 0 0 0 0 0 0 0 0 0 0 0 0 0 0 85 86 87 88 89 0 0 0 0 602 603 604 605 606 607 608 609 610 0 0 0 0 0 0 1546 618 619 620 1548 0 0 0 0 0 0 0 0 0 0 0 0 0 1255 1256 1257 1258 1259 1260 1261 1262 1263 1264 0 0 0 0 0 0 0 0 0 0 0 0 0 
0 0 0 0 0 0 0 0 0 0 0 0 0 0 0 0 0 0 0 0 0 0 0 0 0 0 0 0 0 0 0 0 0 0 0 136 137 138 139 140 0 0 0 0 653 654 655 656 657 658 659 660 661 662 0 0 0 0 0 473 0 0 0 473 0 0 0 0 0 0 0 0 0 0 0 0 0 1306 1307 1308 1309 1310 1311 1312 1313 1314 1315 0 0 0 0 0 0 0 0 0 0 0 0 0 
0 0 0 0 0 0 0 0 0 0 0 0 0 0 0 0 0 0 0 0 0 0 0 0 0 0 0 0 0 0 0 0 0 0 0 187 188 189 190 191 0 0 0 0 0 705 706 707 708 709 710 711 712 713 0 0 0 0 0 0 0 0 0 0 0 0 0 0 0 0 0 0 0 0 0 0 0 1357 1358 1359 1360 1361 1362 1363 1364 1365 0 0 0 0 0 0 0 0 0 0 35 36 37 38 
0 0 0 0 0 0 0 0 0 0 0 0 0 0 0 0 0 0 0 0 0 0 0 0 0 0 0 0 0 0 0 0 0 0 0 0 0 240 241 242 0 0 0 0 0 756 757 758 759 760 761 762 763 764 0 0 0 0 0 0 0 1626 0 0 0 0 0 0 0 0 0 0 0 0 0 0 0 0 1409 1410 1411 1412 1413 1414 1415 1416 0 0 0 0 0 0 1394 1394 1394 85 86 87 88 89 
0 0 0 0 0 0 0 0 0 0 0 0 0 0 0 0 0 0 0 0 0 0 0 0 0 0 0 0 0 0 0 0 0 0 0 0 0 291 0 0 0 1550 1551 1552 0 0 0 809 810 811 812 813 0 0 0 0 0 0 0 0 0 1677 0 893 894 895 896 897 0 0 0 0 0 0 0 0 0 0 1460 1461 1462 1463 1464 1465 1466 1467 0 0 0 0 1445 1445 1446 1445 1445 1446 1446 1445 1446 1445 
0 0 0 0 0 0 0 0 0 0 0 0 0 0 0 0 0 0 0 0 0 0 0 0 0 0 0 0 0 0 0 0 0 0 0 0 0 0 0 0 0 0 0 0 0 0 0 0 861 472 0 636 637 638 636 637 638 636 637 638 639 0 943 944 945 946 947 948 0 0 0 0 0 0 0 0 0 0 0 0 1513 1514 0 0 0 0 1444 1446 1445 1446 0 0 0 0 0 0 0 0 0 0 
0 0 0 0 0 892 893 894 895 896 897 0 0 0 0 0 0 0 0 0 0 0 175 176 177 178 179 180 0 0 0 0 0 411 412 472 0 0 0 418 417 268 264 269 266 264 264 264 912 0 2308 2309 257 1728 1730 1732 1731 1626 1629 257 2056 2057 994 995 996 997 998 999 0 0 0 0 0 0 0 0 0 0 0 0 1564 1565 0 0 0 0 0 0 0 0 0 0 0 0 0 0 0 0 0 0 
0 0 0 0 0 943 944 945 946 947 948 0 0 0 0 0 0 0 0 0 0 0 226 227 228 229 230 231 0 0 0 0 0 473 473 418 271 0 0 0 418 0 0 0 0 0 0 0 963 0 0 0 0 1779 1781 1783 1782 1677 1680 0 0 0 0 1046 1047 1048 1049 0 0 0 0 0 0 0 0 0 0 0 0 0 0 1616 0 0 0 0 0 0 0 0 0 0 0 0 0 0 0 0 0 0 
0 0 0 0 0 994 995 996 997 998 999 0 0 0 0 0 0 0 0 0 0 0 277 278 279 280 281 282 283 0 0 0 0 531 0 0 418 0 0 0 419 0 0 0 0 409 410 0 1014 0 0 1784 0 0 0 0 0 0 0 0 1784 0 0 0 1098 1099 1100 0 0 0 0 0 0 0 0 0 0 0 0 473 0 1445 0 0 472 473 0 0 0 0 0 0 0 0 0 0 0 0 0 0 
22 23 24 25 26 0 1046 1047 1048 1049 0 0 0 0 0 0 0 0 0 0 0 0 0 0 330 331 332 333 0 411 412 0 16 582 0 0 0 0 0 0 0 1728 0 0 0 472 473 0 0 0 0 0 0 0 0 0 0 0 0 0 0 0 0 0 0 0 473 0 0 0 0 0 0 0 0 0 0 0 0 0 0 1798 0 0 0 0 0 0 0 0 0 0 0 0 0 0 0 0 0 0 
73 74 75 76 77 0 0 1098 1099 1100 0 0 0 0 0 0 0 0 0 0 0 0 0 0 0 0 0 0 0 472 473 474 474 633 0 0 0 0 0 0 1629 1779 0 0 0 0 0 0 0 0 0 0 0 0 0 0 0 0 0 0 0 0 0 0 0 0 0 0 0 0 0 0 0 0 154 155 155 155 0 0 0 1696 0 0 0 0 0 0 0 0 0 0 0 0 0 0 0 0 0 0 
0 0 0 0 0 0 0 0 0 473 0 0 0 0 0 0 411 412 0 0 0 0 0 0 0 411 412 0 0 0 0 0 0 684 0 0 0 0 0 0 1680 360 1731 0 0 0 0 0 0 0 0 0 0 0 0 0 0 0 0 0 0 0 0 0 0 0 0 0 0 472 474 473 0 0 1729 1628 1627 1629 0 0 0 1747 0 0 0 0 0 0 0 0 0 0 0 0 0 0 0 0 0 0 
0 0 0 0 0 0 0 0 0 0 0 0 0 0 0 0 473 0 0 0 0 0 0 0 0 0 473 0 0 0 0 0 0 735 0 0 0 0 0 0 0 0 1782 0 0 0 0 0 0 0 0 0 0 0 0 0 0 0 0 0 0 0 0 0 0 0 0 0 0 0 0 0 0 0 1780 1679 1678 1680 0 1388 1388 1747 0 0 0 0 0 0 0 0 0 0 0 0 0 0 0 0 0 0 
0 0 0 0 0 0 0 0 0 0 0 0 0 0 0 0 0 0 0 0 0 0 0 0 0 0 273 0 0 0 0 0 0 786 0 0 0 0 0 0 0 0 0 0 0 0 0 0 0 0 0 0 0 0 0 0 0 0 0 0 0 0 0 0 0 0 0 0 0 0 0 0 0 0 0 0 0 0 0 0 1797 1798 0 0 0 0 0 0 0 0 0 0 0 0 0 0 0 0 0 0

0 0 0 0 0 0 0 0 0 0 0 0 0 0 0 0 0 0 0 0 0 0 0 0 0 0 0 0 0 0 0 0 0 0 0 0 0 0 0 0 0 0 0 0 0 0 0 0 0 0 0 0 0 0 0 0 0 0 0 0 0 0 0 0 0 0 0 0 0 0 0 0 0 0 0 0 0 0 0 0 0 0 0 0 0 0 0 0 0 0 0 0 0 0 0 0 0 0 0 0 
0 0 0 0 0 0 0 0 0 0 0 0 0 0 0 0 0 0 0 0 0 0 0 0 0 0 0 0 0 0 0 0 0 0 0 0 0 0 0 0 2 0 0 0 0 0 0 2 0 0 0 0 0 0 0 0 0 0 0 0 0 0 0 0 0 0 0 0 0 0 0 0 0 0 0 0 0 0 0 0 0 0 0 0 0 0 0 0 0 0 0 0 0 0 0 0 0 0 0 0
0 0 0 0 0 0 0 0 0 0 0 0 0 0 0 0 0 0 0 0 0 0 0 0 0 0 0 0 0 0 0 0 0 0 0 0 0 0 0 0 0 0 0 0 0 0 0 0 0 0 0 0 0 0 0 0 0 0 0 1 1 1 1 1 0 0 0 0 0 0 0 0 0 0 0 0 0 0 0 0 0 0 0 0 0 0 0 0 0 0 0 0 0 0 0 0 0 0 0 0 
0 0 0 0 0 0 0 0 0 0 0 0 0 0 0 0 0 0 0 0 0 0 0 0 0 0 0 0 0 0 0 0 0 0 0 0 0 0 0 0 0 0 0 0 0 0 0 0 0 0 2 0 0 0 0 0 0 0 0 0 0 0 0 0 0 0 0 0 0 0 0 0 0 0 0 0 0 0 0 0 0 0 0 0 0 0 0 0 0 0 0 0 0 0 0 0 0 0 0 0
0 0 0 0 0 0 0 0 0 0 0 0 0 0 0 0 0 0 0 0 0 0 0 0 0 0 0 0 0 0 0 0 0 0 0 0 0 0 0 0 0 0 0 0 0 0 0 0 0 0 0 0 0 0 0 0 0 0 0 0 0 0 2 0 0 0 0 0 0 0 0 0 0 0 0 0 0 0 0 0 0 0 0 0 0 0 0 0 0 0 0 0 0 0 0 0 0 0 0 0
0 0 0 0 0 0 0 0 0 0 0 0 0 0 0 0 0 0 0 0 0 0 0 0 0 0 0 0 0 0 0 0 0 0 0 0 0 0 0 0 0 0 0 0 0 0 0 0 0 0 0 0 0 0 0 0 0 0 0 0 0 0 0 0 0 0 0 0 0 0 0 0 0 0 0 0 0 0 0 0 0 0 0 0 0 0 0 0 0 0 1 1 1 1 1 1 1 1 1 1
0 0 0 0 2 0 0 0 0 0 0 0 0 0 0 0 0 0 0 0 0 0 0 0 0 0 0 0 0 0 0 0 0 0 0 0 0 1 1 1 1 1 1 1 1 1 1 1 1 1 0 0 0 0 0 0 0 0 0 0 0 0 0 0 0 0 0 0 0 0 0 0 0 0 0 0 0 0 0 0 0 0 0 0 0 0 0 1 1 1 1 0 0 0 0 0 0 0 0 0
0 0 0 0 0 0 0 0 0 0 0 0 0 0 0 0 0 0 0 0 0 2 0 0 0 0 0 0 0 0 0 0 0 0 0 1 1 1 0 0 0 0 0 0 0 0 0 0 0 0 0 0 0 0 0 0 0 0 0 0 0 0 0 0 0 0 0 0 0 0 0 0 0 0 0 0 0 0 0 0 0 0 0 0 0 0 0 1 0 0 0 0 0 0 0 0 0 0 0 0
0 0 0 0 0 0 0 0 0 0 0 0 0 0 0 0 0 0 0 0 0 0 0 0 0 0 0 0 0 0 0 0 0 1 1 1 0 0 0 0 0 0 0 0 0 0 0 0 0 0 0 0 0 0 0 0 0 0 0 0 0 0 0 0 0 0 0 0 0 0 0 0 0 0 0 0 0 0 0 0 0 0 0 0 0 0 0 1 0 0 0 0 0 0 0 0 0 0 0 0
0 0 0 0 0 0 0 0 0 0 0 0 0 0 0 0 0 0 0 0 0 0 0 0 0 0 0 0 0 0 0 0 0 1 1 1 0 0 0 0 0 0 0 0 0 0 0 0 0 0 0 0 0 0 0 0 0 0 0 0 0 0 0 0 0 0 0 0 0 0 0 0 0 0 0 0 0 0 0 1 1 1 1 1 1 1 0 1 1 0 0 0 0 0 0 0 0 0 0 0 
0 0 0 0 0 0 0 0 0 0 0 0 0 0 0 0 0 0 0 0 0 0 0 0 0 0 0 0 0 0 0 0 1 0 0 1 1 0 0 0 0 0 0 0 0 1 1 1 1 1 1 1 1 1 1 1 1 1 1 1 1 1 1 1 1 1 1 0 0 0 0 0 0 0 0 0 0 0 1 1 0 0 0 0 0 0 0 0 1 1 0 0 0 0 0 0 0 0 0 0
0 0 0 0 0 0 0 0 0 0 0 0 0 0 0 0 0 0 0 0 0 0 0 0 0 0 0 0 0 1 1 1 1 0 0 0 1 0 0 0 0 0 0 0 0 1 0 0 0 0 0 0 0 0 0 0 0 0 0 0 0 0 0 0 0 1 1 0 0 0 0 0 0 0 0 0 0 0 1 0 0 0 0 0 0 0 0 0 0 1 1 0 0 0 0 0 0 0 0 0 
1 1 1 1 1 1 1 1 1 1 0 0 0 0 0 0 0 0 0 0 0 0 0 0 0 0 0 0 0 1 1 1 1 0 0 0 0 0 0 0 0 0 0 0 0 0 0 0 0 0 0 0 0 0 0 0 0 0 0 0 0 0 0 0 1 1 0 0 0 1 1 1 0 0 1 1 1 1 1 0 0 0 0 0 0 0 0 0 0 0 1 1 1 1 1 0 0 0 0 0 
0 0 0 0 0 0 0 1 1 0 0 0 0 0 0 0 1 1 1 1 1 1 1 1 1 1 1 0 0 0 0 0 0 0 0 0 0 0 0 0 0 0 0 0 0 0 0 0 0 0 0 0 0 0 0 0 0 0 0 0 0 0 0 1 1 0 0 0 0 0 0 0 0 0 0 0 0 0 0 0 0 0 0 0 0 0 0 0 0 0 0 0 0 1 1 0 0 0 0 0 
0 0 0 0 0 0 1 1 0 0 0 0 0 0 0 0 1 0 0 0 0 0 0 0 0 0 1 0 0 0 0 0 0 0 0 0 0 0 0 0 0 0 0 0 0 0 0 0 0 0 0 0 0 0 0 0 0 0 0 0 0 0 1 1 0 0 0 0 0 0 0 0 0 0 0 0 0 0 0 0 0 0 0 0 0 0 0 0 0 0 0 0 0 0 0 0 0 0 0 0
